start,end,length,strand,frame,chromosome
12045,12426,381,1,0,chrI
24477,24879,402,1,0,chrI
26733,27159,426,1,0,chrI
31566,32940,1374,1,0,chrI
33447,34701,1254,1,0,chrI
35154,36303,1149,1,0,chrI
39258,41901,2643,1,0,chrI
59052,59409,357,1,0,chrI
74019,74823,804,1,0,chrI
94686,95472,786,1,0,chrI
104526,104847,321,1,0,chrI
114249,114819,570,1,0,chrI
114918,118314,3396,1,0,chrI
124878,126786,1908,1,0,chrI
132159,134076,1917,1,0,chrI
143706,147531,3825,1,0,chrI
149400,149841,441,1,0,chrI
152256,153876,1620,1,0,chrI
155004,156285,1281,1,0,chrI
169374,170295,921,1,0,chrI
177093,177450,357,1,0,chrI
188106,188811,705,1,0,chrI
192618,196185,3567,1,0,chrI
220197,220497,300,1,0,chrI
222405,222891,486,1,0,chrI
225459,226863,1404,1,0,chrI
228843,229317,474,1,0,chrI
334,649,315,1,1,chrI
10090,10399,309,1,1,chrI
36508,37147,639,1,1,chrI
45898,48250,2352,1,1,chrI
54583,54913,330,1,1,chrI
57517,57850,333,1,1,chrI
61315,62563,1248,1,1,chrI
62839,65404,2565,1,1,chrI
69046,69505,459,1,1,chrI
71785,73288,1503,1,1,chrI
76426,79435,3009,1,1,chrI
79717,80587,870,1,1,chrI
82705,83227,522,1,1,chrI
92899,94486,1587,1,1,chrI
109387,109801,414,1,1,chrI
130798,131983,1185,1,1,chrI
135853,136633,780,1,1,chrI
158890,159793,903,1,1,chrI
174997,175330,333,1,1,chrI
183769,184477,708,1,1,chrI
184891,185596,705,1,1,chrI
186835,187732,897,1,1,chrI
190192,192256,2064,1,1,chrI
218548,219145,597,1,1,chrI
37463,38972,1509,1,2,chrI
42176,42719,543,1,2,chrI
48563,51707,3144,1,2,chrI
57137,57437,300,1,2,chrI
77390,77693,303,1,2,chrI
84668,84977,309,1,2,chrI
112961,113336,375,1,2,chrI
120224,124295,4071,1,2,chrI
128561,128999,438,1,2,chrI
129269,130487,1218,1,2,chrI
136913,137510,597,1,2,chrI
140759,141407,648,1,2,chrI
190421,191003,582,1,2,chrI
203402,208016,4614,1,2,chrI
221048,221660,612,1,2,chrI
227741,228953,1212,1,2,chrI
217156,217492,336,-1,0,chrI
207130,207511,381,-1,0,chrI
204211,204637,426,-1,0,chrI
201466,201787,321,-1,0,chrI
191179,191539,360,-1,0,chrI
186511,186853,342,-1,0,chrI
172210,175135,2925,-1,0,chrI
170395,171703,1308,-1,0,chrI
166741,168871,2130,-1,0,chrI
128251,129019,768,-1,0,chrI
113875,114208,333,-1,0,chrI
110845,113359,2514,-1,0,chrI
109576,109912,336,-1,0,chrI
95629,99697,4068,-1,0,chrI
84748,87031,2283,-1,0,chrI
77188,77665,477,-1,0,chrI
72325,73300,975,-1,0,chrI
57949,58483,534,-1,0,chrI
57487,57796,309,-1,0,chrI
57028,57385,357,-1,0,chrI
54988,56857,1869,-1,0,chrI
50818,51124,306,-1,0,chrI
42880,45022,2142,-1,0,chrI
38695,39046,351,-1,0,chrI
7234,9016,1782,-1,0,chrI
224562,224862,300,-1,1,chrI
179280,179820,540,-1,1,chrI
160596,164187,3591,-1,1,chrI
156753,158619,1866,-1,1,chrI
137697,138345,648,-1,1,chrI
118563,119541,978,-1,1,chrI
115869,116418,549,-1,1,chrI
113613,114615,1002,-1,1,chrI
108876,110430,1554,-1,1,chrI
100224,101145,921,-1,1,chrI
95385,95823,438,-1,1,chrI
83334,84474,1140,-1,1,chrI
80709,82101,1392,-1,1,chrI
79488,79842,354,-1,1,chrI
78387,78933,546,-1,1,chrI
75042,76152,1110,-1,1,chrI
72213,72696,483,-1,1,chrI
68715,69525,810,-1,1,chrI
61230,61608,378,-1,1,chrI
52800,54789,1989,-1,1,chrI
36495,36918,423,-1,1,chrI
34104,34476,372,-1,1,chrI
13362,13743,381,-1,1,chrI
1806,2169,363,-1,1,chrI
228536,228863,327,-1,2,chrI
192932,193430,498,-1,2,chrI
164543,165866,1323,-1,2,chrI
157802,158126,324,-1,2,chrI
154064,154724,660,-1,2,chrI
152477,152879,402,-1,2,chrI
147593,150695,3102,-1,2,chrI
142670,142976,306,-1,2,chrI
139502,141431,1929,-1,2,chrI
134183,135665,1482,-1,2,chrI
126902,128102,1200,-1,2,chrI
124754,125069,315,-1,2,chrI
106271,108551,2280,-1,2,chrI
101564,105872,4308,-1,2,chrI
87854,92270,4416,-1,2,chrI
65777,67520,1743,-1,2,chrI
58694,61052,2358,-1,2,chrI
51854,52595,741,-1,2,chrI
38216,38573,357,-1,2,chrI
23999,27968,3969,-1,2,chrI
11564,11951,387,-1,2,chrI
645,1128,483,1,0,chrII
1428,2508,1080,1,0,chrII
29934,31251,1317,1,0,chrII
39144,40527,1383,1,0,chrII
40830,43095,2265,1,0,chrII
71865,72972,1107,1,0,chrII
75258,79767,4509,1,0,chrII
87645,87957,312,1,0,chrII
107931,109995,2064,1,0,chrII
117588,119166,1578,1,0,chrII
119334,119709,375,1,0,chrII
132423,133749,1326,1,0,chrII
141246,141972,726,1,0,chrII
171480,171918,438,1,0,chrII
172533,174588,2055,1,0,chrII
176997,177390,393,1,0,chrII
182400,184125,1725,1,0,chrII
192450,193512,1062,1,0,chrII
194121,195702,1581,1,0,chrII
209652,212175,2523,1,0,chrII
224400,224712,312,1,0,chrII
242808,244230,1422,1,0,chrII
261669,265140,3471,1,0,chrII
270246,270633,387,1,0,chrII
281442,283344,1902,1,0,chrII
283737,284271,534,1,0,chrII
300165,301254,1089,1,0,chrII
301518,301821,303,1,0,chrII
309366,309735,369,1,0,chrII
382029,382674,645,1,0,chrII
403107,403482,375,1,0,chrII
434460,434880,420,1,0,chrII
436020,436713,693,1,0,chrII
436950,441315,4365,1,0,chrII
447708,449316,1608,1,0,chrII
454821,457665,2844,1,0,chrII
458871,460221,1350,1,0,chrII
463209,463635,426,1,0,chrII
467247,469620,2373,1,0,chrII
489450,489759,309,1,0,chrII
502245,502593,348,1,0,chrII
518370,518724,354,1,0,chrII
522210,522513,303,1,0,chrII
524598,524934,336,1,0,chrII
536574,537465,891,1,0,chrII
543666,544077,411,1,0,chrII
546375,547251,876,1,0,chrII
556548,558198,1650,1,0,chrII
558684,559728,1044,1,0,chrII
561633,562764,1131,1,0,chrII
565722,567480,1758,1,0,chrII
568851,569685,834,1,0,chrII
572370,573612,1242,1,0,chrII
583719,584658,939,1,0,chrII
589740,591459,1719,1,0,chrII
600552,602163,1611,1,0,chrII
606696,607140,444,1,0,chrII
620871,622527,1656,1,0,chrII
633621,634836,1215,1,0,chrII
635145,636543,1398,1,0,chrII
638778,639105,327,1,0,chrII
642582,642900,318,1,0,chrII
645549,645978,429,1,0,chrII
649305,649674,369,1,0,chrII
650367,651192,825,1,0,chrII
651414,652998,1584,1,0,chrII
653445,655317,1872,1,0,chrII
657831,658392,561,1,0,chrII
670626,673329,2703,1,0,chrII
675312,676227,915,1,0,chrII
683427,684669,1242,1,0,chrII
691968,694518,2550,1,0,chrII
705480,705816,336,1,0,chrII
721389,722313,924,1,0,chrII
722610,723054,444,1,0,chrII
724455,726540,2085,1,0,chrII
730386,732453,2067,1,0,chrII
734841,735285,444,1,0,chrII
736038,737736,1698,1,0,chrII
760293,760899,606,1,0,chrII
761256,762594,1338,1,0,chrII
774621,776313,1692,1,0,chrII
787005,788430,1425,1,0,chrII
789234,791814,2580,1,0,chrII
805350,807105,1755,1,0,chrII
1414,2425,1011,1,1,chrII
8176,8482,306,1,1,chrII
24097,24745,648,1,1,chrII
27337,27847,510,1,1,chrII
31207,35248,4041,1,1,chrII
43276,44089,813,1,1,chrII
49423,50953,1530,1,1,chrII
58927,59374,447,1,1,chrII
70042,70540,498,1,1,chrII
80896,81328,432,1,1,chrII
81340,81652,312,1,1,chrII
92329,93394,1065,1,1,chrII
105307,105688,381,1,1,chrII
110593,110896,303,1,1,chrII
111436,112708,1272,1,1,chrII
113761,115168,1407,1,1,chrII
135997,136366,369,1,1,chrII
136687,137461,774,1,1,chrII
147208,150286,3078,1,1,chrII
160183,161329,1146,1,1,chrII
161698,162715,1017,1,1,chrII
207193,209224,2031,1,1,chrII
221329,222652,1323,1,1,chrII
227635,235117,7482,1,1,chrII
236491,236887,396,1,1,chrII
242053,242356,303,1,1,chrII
245905,246547,642,1,1,chrII
247009,248503,1494,1,1,chrII
256330,256741,411,1,1,chrII
262939,263419,480,1,1,chrII
284809,285166,357,1,1,chrII
289444,290350,906,1,1,chrII
298291,299950,1659,1,1,chrII
315574,316510,936,1,1,chrII
318265,320275,2010,1,1,chrII
337987,338338,351,1,1,chrII
347878,349384,1506,1,1,chrII
367762,368191,429,1,1,chrII
380410,381046,636,1,1,chrII
390226,391291,1065,1,1,chrII
409168,410629,1461,1,1,chrII
425182,425782,600,1,1,chrII
441514,443590,2076,1,1,chrII
463930,464341,411,1,1,chrII
465565,466048,483,1,1,chrII
477670,479047,1377,1,1,chrII
485650,485992,342,1,1,chrII
504853,505306,453,1,1,chrII
513043,513583,540,1,1,chrII
528316,530638,2322,1,1,chrII
533761,534817,1056,1,1,chrII
539986,541021,1035,1,1,chrII
547459,548194,735,1,1,chrII
560077,560974,897,1,1,chrII
605965,606277,312,1,1,chrII
607651,608785,1134,1,1,chrII
609118,609439,321,1,1,chrII
612865,613708,843,1,1,chrII
623575,624211,636,1,1,chrII
625771,628309,2538,1,1,chrII
629167,631942,2775,1,1,chrII
633994,634312,318,1,1,chrII
634600,634924,324,1,1,chrII
685450,685765,315,1,1,chrII
707527,708016,489,1,1,chrII
719032,720604,1572,1,1,chrII
728884,729724,840,1,1,chrII
731542,731854,312,1,1,chrII
739840,741022,1182,1,1,chrII
741298,741616,318,1,1,chrII
749593,751177,1584,1,1,chrII
769009,769309,300,1,1,chrII
771238,773632,2394,1,1,chrII
782590,783556,966,1,1,chrII
798169,798502,333,1,1,chrII
809056,809419,363,1,1,chrII
5789,6125,336,1,2,chrII
37052,38690,1638,1,2,chrII
45977,46370,393,1,2,chrII
48824,49358,534,1,2,chrII
61559,61943,384,1,2,chrII
63875,66818,2943,1,2,chrII
90740,92030,1290,1,2,chrII
99962,100307,345,1,2,chrII
101885,105221,3336,1,2,chrII
125303,126119,816,1,2,chrII
126827,127244,417,1,2,chrII
127298,127610,312,1,2,chrII
131024,131345,321,1,2,chrII
146186,146885,699,1,2,chrII
153143,153455,312,1,2,chrII
166133,167264,1131,1,2,chrII
184352,185915,1563,1,2,chrII
200543,200849,306,1,2,chrII
202055,203261,1206,1,2,chrII
203537,205817,2280,1,2,chrII
217469,220400,2931,1,2,chrII
223130,226598,3468,1,2,chrII
259868,261191,1323,1,2,chrII
279020,280607,1587,1,2,chrII
301943,304703,2760,1,2,chrII
311897,314789,2892,1,2,chrII
316967,317864,897,1,2,chrII
325004,325346,342,1,2,chrII
331832,332360,528,1,2,chrII
333368,333812,444,1,2,chrII
343100,344135,1035,1,2,chrII
377003,377312,309,1,2,chrII
383111,385988,2877,1,2,chrII
386285,389216,2931,1,2,chrII
393758,394742,984,1,2,chrII
411053,413981,2928,1,2,chrII
415982,416906,924,1,2,chrII
423764,424829,1065,1,2,chrII
432035,434297,2262,1,2,chrII
449666,450656,990,1,2,chrII
452657,453224,567,1,2,chrII
479417,480323,906,1,2,chrII
486506,486866,360,1,2,chrII
497162,499277,2115,1,2,chrII
504242,504644,402,1,2,chrII
505667,512774,7107,1,2,chrII
515663,517190,1527,1,2,chrII
535259,536096,837,1,2,chrII
537875,539705,1830,1,2,chrII
545027,545978,951,1,2,chrII
549770,550928,1158,1,2,chrII
578363,578984,621,1,2,chrII
581822,582125,303,1,2,chrII
582407,583355,948,1,2,chrII
586070,586445,375,1,2,chrII
596114,597065,951,1,2,chrII
597362,598934,1572,1,2,chrII
602633,603476,843,1,2,chrII
610037,610409,372,1,2,chrII
618908,620303,1395,1,2,chrII
647885,649904,2019,1,2,chrII
661517,662081,564,1,2,chrII
670124,670640,516,1,2,chrII
686900,690263,3363,1,2,chrII
704669,705386,717,1,2,chrII
711590,712754,1164,1,2,chrII
723269,723635,366,1,2,chrII
738581,739544,963,1,2,chrII
744851,746111,1260,1,2,chrII
768239,768680,441,1,2,chrII
773921,774356,435,1,2,chrII
776570,777854,1284,1,2,chrII
779666,782384,2718,1,2,chrII
792848,796499,3651,1,2,chrII
800522,801929,1407,1,2,chrII
802630,804475,1845,-1,0,chrII
748060,749371,1311,-1,0,chrII
742159,742576,417,-1,0,chrII
729733,730162,429,-1,0,chrII
716881,717994,1113,-1,0,chrII
702817,703204,387,-1,0,chrII
700489,701842,1353,-1,0,chrII
698353,699943,1590,-1,0,chrII
690382,691693,1311,-1,0,chrII
688105,688405,300,-1,0,chrII
668662,670297,1635,-1,0,chrII
666925,667243,318,-1,0,chrII
665152,666253,1101,-1,0,chrII
662734,663091,357,-1,0,chrII
616126,618523,2397,-1,0,chrII
615202,615856,654,-1,0,chrII
612235,613900,1665,-1,0,chrII
599122,599959,837,-1,0,chrII
586546,589114,2568,-1,0,chrII
584806,586162,1356,-1,0,chrII
582337,582652,315,-1,0,chrII
581725,582172,447,-1,0,chrII
576343,578086,1743,-1,0,chrII
567874,568426,552,-1,0,chrII
541372,541690,318,-1,0,chrII
538666,539080,414,-1,0,chrII
499651,501442,1791,-1,0,chrII
487198,488380,1182,-1,0,chrII
484741,486691,1950,-1,0,chrII
481363,483367,2004,-1,0,chrII
477856,478834,978,-1,0,chrII
474391,476437,2046,-1,0,chrII
469747,473926,4179,-1,0,chrII
463951,464392,441,-1,0,chrII
457918,458362,444,-1,0,chrII
455359,455692,333,-1,0,chrII
454852,455176,324,-1,0,chrII
450880,451969,1089,-1,0,chrII
429547,430951,1404,-1,0,chrII
412564,412906,342,-1,0,chrII
406627,406960,333,-1,0,chrII
393571,394150,579,-1,0,chrII
391804,392293,489,-1,0,chrII
376573,378433,1860,-1,0,chrII
370036,370699,663,-1,0,chrII
364786,365719,933,-1,0,chrII
356860,360187,3327,-1,0,chrII
353671,356083,2412,-1,0,chrII
352192,353293,1101,-1,0,chrII
348667,348979,312,-1,0,chrII
338719,339352,633,-1,0,chrII
335578,335908,330,-1,0,chrII
324340,326059,1719,-1,0,chrII
315592,315967,375,-1,0,chrII
310564,311452,888,-1,0,chrII
306268,306955,687,-1,0,chrII
296368,297742,1374,-1,0,chrII
294424,296002,1578,-1,0,chrII
292876,294019,1143,-1,0,chrII
290680,291865,1185,-1,0,chrII
274426,275527,1101,-1,0,chrII
270946,273703,2757,-1,0,chrII
270253,270598,345,-1,0,chrII
267709,269503,1794,-1,0,chrII
252562,254209,1647,-1,0,chrII
235393,235792,399,-1,0,chrII
216586,217129,543,-1,0,chrII
205126,205468,342,-1,0,chrII
199063,201748,2685,-1,0,chrII
185317,185800,483,-1,0,chrII
184783,185092,309,-1,0,chrII
174919,177526,2607,-1,0,chrII
160948,161305,357,-1,0,chrII
153847,158389,4542,-1,0,chrII
151492,153610,2118,-1,0,chrII
142111,142582,471,-1,0,chrII
138340,140260,1920,-1,0,chrII
127894,132040,4146,-1,0,chrII
122752,124759,2007,-1,0,chrII
90604,90925,321,-1,0,chrII
88522,89125,603,-1,0,chrII
80377,80731,354,-1,0,chrII
78475,78799,324,-1,0,chrII
73069,74695,1626,-1,0,chrII
69712,70138,426,-1,0,chrII
67168,69445,2277,-1,0,chrII
61201,62602,1401,-1,0,chrII
59821,60169,348,-1,0,chrII
47362,48628,1266,-1,0,chrII
46564,46864,300,-1,0,chrII
36988,37303,315,-1,0,chrII
22075,23536,1461,-1,0,chrII
10846,13879,3033,-1,0,chrII
2581,2899,318,-1,0,chrII
810339,811479,1140,-1,1,chrII
808599,809097,498,-1,1,chrII
796797,798522,1725,-1,1,chrII
784701,785073,372,-1,1,chrII
783672,784572,900,-1,1,chrII
782634,782997,363,-1,1,chrII
778011,779463,1452,-1,1,chrII
768942,770415,1473,-1,1,chrII
762783,764712,1929,-1,1,chrII
739935,740388,453,-1,1,chrII
737769,738426,657,-1,1,chrII
723735,724263,528,-1,1,chrII
719979,720288,309,-1,1,chrII
702588,704055,1467,-1,1,chrII
695106,697302,2196,-1,1,chrII
685437,686592,1155,-1,1,chrII
679548,679965,417,-1,1,chrII
676356,679221,2865,-1,1,chrII
662994,664677,1683,-1,1,chrII
655575,657600,2025,-1,1,chrII
636702,642210,5508,-1,1,chrII
632253,633381,1128,-1,1,chrII
627171,627696,525,-1,1,chrII
609081,609753,672,-1,1,chrII
603684,604107,423,-1,1,chrII
593505,594864,1359,-1,1,chrII
591711,592236,525,-1,1,chrII
571467,571890,423,-1,1,chrII
569841,571200,1359,-1,1,chrII
563202,564570,1368,-1,1,chrII
553542,554310,768,-1,1,chrII
551103,553200,2097,-1,1,chrII
548361,549009,648,-1,1,chrII
530868,532182,1314,-1,1,chrII
495591,496869,1278,-1,1,chrII
494352,495339,987,-1,1,chrII
493080,494115,1035,-1,1,chrII
491268,492822,1554,-1,1,chrII
488904,490392,1488,-1,1,chrII
483969,484560,591,-1,1,chrII
474198,474726,528,-1,1,chrII
453792,454530,738,-1,1,chrII
443820,444693,873,-1,1,chrII
442923,443307,384,-1,1,chrII
441627,442056,429,-1,1,chrII
426189,426489,300,-1,1,chrII
424989,425766,777,-1,1,chrII
398613,400890,2277,-1,1,chrII
395382,398277,2895,-1,1,chrII
373860,375690,1830,-1,1,chrII
372102,372735,633,-1,1,chrII
368583,369678,1095,-1,1,chrII
366969,368184,1215,-1,1,chrII
360651,362514,1863,-1,1,chrII
358098,358449,351,-1,1,chrII
357297,357645,348,-1,1,chrII
344601,347301,2700,-1,1,chrII
337182,338199,1017,-1,1,chrII
320415,321609,1194,-1,1,chrII
304929,305976,1047,-1,1,chrII
284427,287925,3498,-1,1,chrII
276252,278352,2100,-1,1,chrII
266724,267336,612,-1,1,chrII
265491,265881,390,-1,1,chrII
259146,259566,420,-1,1,chrII
255372,255684,312,-1,1,chrII
248805,251016,2211,-1,1,chrII
244365,245667,1302,-1,1,chrII
241707,242568,861,-1,1,chrII
231648,231951,303,-1,1,chrII
212631,216366,3735,-1,1,chrII
206106,206949,843,-1,1,chrII
194940,195438,498,-1,1,chrII
194307,194913,606,-1,1,chrII
186843,191583,4740,-1,1,chrII
185997,186306,309,-1,1,chrII
181659,182094,435,-1,1,chrII
177873,181275,3402,-1,1,chrII
167517,167838,321,-1,1,chrII
158655,159693,1038,-1,1,chrII
143988,145728,1740,-1,1,chrII
134142,135516,1374,-1,1,chrII
115572,116829,1257,-1,1,chrII
112800,113427,627,-1,1,chrII
105315,107406,2091,-1,1,chrII
90222,90531,309,-1,1,chrII
86721,87789,1068,-1,1,chrII
84498,86448,1950,-1,1,chrII
81042,84261,3219,-1,1,chrII
69750,71127,1377,-1,1,chrII
51018,59382,8364,-1,1,chrII
50349,50775,426,-1,1,chrII
49494,49836,342,-1,1,chrII
43764,44097,333,-1,1,chrII
43173,43482,309,-1,1,chrII
33126,33441,315,-1,1,chrII
24945,28299,3354,-1,1,chrII
24258,24570,312,-1,1,chrII
9960,10551,591,-1,1,chrII
279,2658,2379,-1,1,chrII
789596,789989,393,-1,2,chrII
764969,767606,2637,-1,2,chrII
760214,760616,402,-1,2,chrII
757619,760043,2424,-1,2,chrII
751355,757106,5751,-1,2,chrII
746360,747803,1443,-1,2,chrII
742760,744398,1638,-1,2,chrII
735719,736040,321,-1,2,chrII
734831,735530,699,-1,2,chrII
732638,734639,2001,-1,2,chrII
727385,728102,717,-1,2,chrII
714806,716465,1659,-1,2,chrII
713003,714455,1452,-1,2,chrII
708149,711539,3390,-1,2,chrII
705446,706793,1347,-1,2,chrII
698624,698957,333,-1,2,chrII
683372,683732,360,-1,2,chrII
682178,683090,912,-1,2,chrII
673571,675134,1563,-1,2,chrII
673154,673565,411,-1,2,chrII
666719,668351,1632,-1,2,chrII
658706,662249,3543,-1,2,chrII
654185,654548,363,-1,2,chrII
652685,652994,309,-1,2,chrII
646157,647132,975,-1,2,chrII
610613,611882,1269,-1,2,chrII
600557,600890,333,-1,2,chrII
590060,590501,441,-1,2,chrII
579149,581522,2373,-1,2,chrII
573914,575996,2082,-1,2,chrII
563849,564164,315,-1,2,chrII
559130,559439,309,-1,2,chrII
541208,544493,3285,-1,2,chrII
533234,533549,315,-1,2,chrII
527024,528038,1014,-1,2,chrII
517349,526628,9279,-1,2,chrII
513761,515336,1575,-1,2,chrII
501803,504287,2484,-1,2,chrII
480434,480923,489,-1,2,chrII
462869,465770,2901,-1,2,chrII
461177,461873,696,-1,2,chrII
445061,447323,2262,-1,2,chrII
434405,435767,1362,-1,2,chrII
427697,429101,1404,-1,2,chrII
427154,427484,330,-1,2,chrII
420200,423041,2841,-1,2,chrII
401252,405251,3999,-1,2,chrII
396518,396848,330,-1,2,chrII
379220,379934,714,-1,2,chrII
365975,366323,348,-1,2,chrII
339674,340751,1077,-1,2,chrII
334385,336818,2433,-1,2,chrII
330506,331511,1005,-1,2,chrII
328172,330092,1920,-1,2,chrII
321875,323945,2070,-1,2,chrII
309080,310313,1233,-1,2,chrII
294023,294356,333,-1,2,chrII
257111,257975,864,-1,2,chrII
238940,241283,2343,-1,2,chrII
237152,237467,315,-1,2,chrII
211016,211469,453,-1,2,chrII
209681,210137,456,-1,2,chrII
203405,203807,402,-1,2,chrII
163040,163997,957,-1,2,chrII
150446,151220,774,-1,2,chrII
119378,121874,2496,-1,2,chrII
100370,101156,786,-1,2,chrII
96668,100115,3447,-1,2,chrII
93638,95882,2244,-1,2,chrII
77855,78278,423,-1,2,chrII
72413,72893,480,-1,2,chrII
44255,44918,663,-1,2,chrII
41921,42284,363,-1,2,chrII
41084,41480,396,-1,2,chrII
18176,21425,3249,-1,2,chrII
14240,17696,3456,-1,2,chrII
4193,5009,816,-1,2,chrII
2906,3779,873,-1,2,chrII
1367,2447,1080,-1,2,chrII
2823,3750,927,1,0,chrIII
9705,11082,1377,1,0,chrIII
13281,13809,528,1,0,chrIII
17289,18561,1272,1,0,chrIII
23526,23925,399,1,0,chrIII
50583,50943,360,1,0,chrIII
52644,54882,2238,1,0,chrIII
59025,60726,1701,1,0,chrIII
70149,71367,1218,1,0,chrIII
71802,73341,1539,1,0,chrIII
76998,77391,393,1,0,chrIII
79161,82275,3114,1,0,chrIII
83619,83997,378,1,0,chrIII
85101,86418,1317,1,0,chrIII
91323,92418,1095,1,0,chrIII
104640,105099,459,1,0,chrIII
109104,110670,1566,1,0,chrIII
111915,112482,567,1,0,chrIII
113079,113541,462,1,0,chrIII
128469,130281,1812,1,0,chrIII
137745,138996,1251,1,0,chrIII
193296,194298,1002,1,0,chrIII
200910,201243,333,1,0,chrIII
204294,204774,480,1,0,chrIII
208851,209406,555,1,0,chrIII
216696,218241,1545,1,0,chrIII
226890,227319,429,1,0,chrIII
237213,238776,1563,1,0,chrIII
244314,244755,441,1,0,chrIII
254370,258654,4284,1,0,chrIII
258882,259269,387,1,0,chrIII
263391,263964,573,1,0,chrIII
266349,266721,372,1,0,chrIII
280116,286443,6327,1,0,chrIII
286761,287937,1176,1,0,chrIII
307800,308175,375,1,0,chrIII
309069,310155,1086,1,0,chrIII
2125,2566,441,1,1,chrIII
13750,14119,369,1,1,chrIII
27928,28936,1008,1,1,chrIII
46639,46963,324,1,1,chrIII
47425,47872,447,1,1,chrIII
61657,62722,1065,1,1,chrIII
71977,72316,339,1,1,chrIII
84466,84787,321,1,1,chrIII
86374,90415,4041,1,1,chrIII
95356,95662,306,1,1,chrIII
96280,101191,4911,1,1,chrIII
108049,108391,342,1,1,chrIII
115684,115999,315,1,1,chrIII
152836,153928,1092,1,1,chrIII
190591,191635,1044,1,1,chrIII
208750,209101,351,1,1,chrIII
213121,213433,312,1,1,chrIII
214993,216445,1452,1,1,chrIII
224398,224734,336,1,1,chrIII
225562,227458,1896,1,1,chrIII
229309,231004,1695,1,1,chrIII
231499,232963,1464,1,1,chrIII
233188,233503,315,1,1,chrIII
234592,234892,300,1,1,chrIII
235462,235837,375,1,1,chrIII
238180,238504,324,1,1,chrIII
252844,254173,1329,1,1,chrIII
262915,263269,354,1,1,chrIII
267433,272263,4830,1,1,chrIII
279238,279598,360,1,1,chrIII
310957,313456,2499,1,1,chrIII
1391,2135,744,1,2,chrIII
7244,7619,375,1,2,chrIII
24767,26906,2139,1,2,chrIII
31448,33974,2526,1,2,chrIII
35864,37616,1752,1,2,chrIII
42164,43556,1392,1,2,chrIII
50837,52340,1503,1,2,chrIII
63440,64481,1041,1,2,chrIII
108020,108791,771,1,2,chrIII
118619,119171,552,1,2,chrIII
136544,136847,303,1,2,chrIII
143633,144506,873,1,2,chrIII
179519,186023,6504,1,2,chrIII
186488,190169,3681,1,2,chrIII
192215,192629,414,1,2,chrIII
200441,200969,528,1,2,chrIII
211928,213761,1833,1,2,chrIII
214070,214739,669,1,2,chrIII
223688,223988,300,1,2,chrIII
228317,228791,474,1,2,chrIII
239054,240011,957,1,2,chrIII
246962,247910,948,1,2,chrIII
251195,251510,315,1,2,chrIII
259577,259961,384,1,2,chrIII
263975,264491,516,1,2,chrIII
265067,266846,1779,1,2,chrIII
274403,276566,2163,1,2,chrIII
313889,314981,1092,1,2,chrIII
302481,303030,549,-1,0,chrIII
300831,301299,468,-1,0,chrIII
297048,298605,1557,-1,0,chrIII
293178,293538,360,-1,0,chrIII
270987,271395,408,-1,0,chrIII
260310,262452,2142,-1,0,chrIII
253638,253947,309,-1,0,chrIII
240804,242352,1548,-1,0,chrIII
240102,240543,441,-1,0,chrIII
233124,236322,3198,-1,0,chrIII
231756,232074,318,-1,0,chrIII
210717,211545,828,-1,0,chrIII
209913,210423,510,-1,0,chrIII
208134,209610,1476,-1,0,chrIII
199545,200178,633,-1,0,chrIII
160743,162222,1479,-1,0,chrIII
156108,157107,999,-1,0,chrIII
154011,154659,648,-1,0,chrIII
141216,142170,954,-1,0,chrIII
122529,123003,474,-1,0,chrIII
120945,122328,1383,-1,0,chrIII
119574,120318,744,-1,0,chrIII
94620,95763,1143,-1,0,chrIII
78948,79296,348,-1,0,chrIII
76017,77919,1902,-1,0,chrIII
74703,75285,582,-1,0,chrIII
73404,73986,582,-1,0,chrIII
68598,69921,1323,-1,0,chrIII
64674,65568,894,-1,0,chrIII
62775,63282,507,-1,0,chrIII
62115,62415,300,-1,0,chrIII
60840,61173,333,-1,0,chrIII
44622,46905,2283,-1,0,chrIII
22428,23379,951,-1,0,chrIII
11502,12285,783,-1,0,chrIII
314351,314738,387,-1,1,chrIII
283391,283703,312,-1,1,chrIII
264005,264467,462,-1,1,chrIII
218375,220067,1692,-1,1,chrIII
206876,207950,1074,-1,1,chrIII
201173,205397,4224,-1,1,chrIII
173825,176438,2613,-1,1,chrIII
170885,172424,1539,-1,1,chrIII
167369,167999,630,-1,1,chrIII
163445,163856,411,-1,1,chrIII
158537,160373,1836,-1,1,chrIII
142559,142874,315,-1,1,chrIII
139184,140933,1749,-1,1,chrIII
138401,139049,648,-1,1,chrIII
132272,133124,852,-1,1,chrIII
110807,111302,495,-1,1,chrIII
106973,107366,393,-1,1,chrIII
105695,106853,1158,-1,1,chrIII
104618,105548,930,-1,1,chrIII
102074,103358,1284,-1,1,chrIII
91985,92297,312,-1,1,chrIII
81569,82085,516,-1,1,chrIII
74720,75083,363,-1,1,chrIII
65933,68333,2400,-1,1,chrIII
50132,50627,495,-1,1,chrIII
39785,40724,939,-1,1,chrIII
37835,38801,966,-1,1,chrIII
34142,35393,1251,-1,1,chrIII
26924,27359,435,-1,1,chrIII
23522,23981,459,-1,1,chrIII
18815,22106,3291,-1,1,chrIII
15797,16880,1083,-1,1,chrIII
304360,305467,1107,-1,2,chrIII
301270,302221,951,-1,2,chrIII
288169,289258,1089,-1,2,chrIII
276763,279907,3144,-1,2,chrIII
272314,272863,549,-1,2,chrIII
250237,252628,2391,-1,2,chrIII
249292,250045,753,-1,2,chrIII
248032,248815,783,-1,2,chrIII
246994,247315,321,-1,2,chrIII
242587,246583,3996,-1,2,chrIII
228094,228505,411,-1,2,chrIII
223453,224230,777,-1,2,chrIII
220456,223228,2772,-1,2,chrIII
213463,213772,309,-1,2,chrIII
211870,212317,447,-1,2,chrIII
206260,206644,384,-1,2,chrIII
197620,199549,1929,-1,2,chrIII
194413,197185,2772,-1,2,chrIII
191833,193018,1185,-1,2,chrIII
182755,183064,309,-1,2,chrIII
174697,175153,456,-1,2,chrIII
173140,173440,300,-1,2,chrIII
164110,166339,2229,-1,2,chrIII
157420,157765,345,-1,2,chrIII
148237,148903,666,-1,2,chrIII
144772,147634,2862,-1,2,chrIII
133723,136873,3150,-1,2,chrIII
130744,131542,798,-1,2,chrIII
126010,126730,720,-1,2,chrIII
117379,118348,969,-1,2,chrIII
103570,104350,780,-1,2,chrIII
92776,94270,1494,-1,2,chrIII
70789,71122,333,-1,2,chrIII
57373,58774,1401,-1,2,chrIII
54940,56527,1587,-1,2,chrIII
48652,50221,1569,-1,2,chrIII
47110,48364,1254,-1,2,chrIII
43660,44437,777,-1,2,chrIII
43117,43501,384,-1,2,chrIII
33463,33916,453,-1,2,chrIII
32209,32614,405,-1,2,chrIII
12385,13018,633,-1,2,chrIII
6478,8326,1848,-1,2,chrIII
16203,17226,1023,1,0,chrIV
20634,21006,372,1,0,chrIV
28467,28770,303,1,0,chrIV
32295,33234,939,1,0,chrIV
42699,43707,1008,1,0,chrIV
44064,45906,1842,1,0,chrIV
59118,59499,381,1,0,chrIV
62010,62562,552,1,0,chrIV
62616,62946,330,1,0,chrIV
66492,67446,954,1,0,chrIV
77583,77886,303,1,0,chrIV
106740,107070,330,1,0,chrIV
111579,114234,2655,1,0,chrIV
126786,130002,3216,1,0,chrIV
139521,141114,1593,1,0,chrIV
159603,160764,1161,1,0,chrIV
162465,162840,375,1,0,chrIV
164289,164865,576,1,0,chrIV
176772,178056,1284,1,0,chrIV
183342,184611,1269,1,0,chrIV
190107,190527,420,1,0,chrIV
190923,192261,1338,1,0,chrIV
199995,201582,1587,1,0,chrIV
216528,217074,546,1,0,chrIV
222426,223740,1314,1,0,chrIV
240258,241197,939,1,0,chrIV
245922,246447,525,1,0,chrIV
248580,251238,2658,1,0,chrIV
251565,253746,2181,1,0,chrIV
255603,256530,927,1,0,chrIV
268920,269976,1056,1,0,chrIV
272388,273597,1209,1,0,chrIV
287058,289512,2454,1,0,chrIV
289908,292140,2232,1,0,chrIV
303210,304848,1638,1,0,chrIV
324828,325140,312,1,0,chrIV
331023,332940,1917,1,0,chrIV
337701,338070,369,1,0,chrIV
363951,364779,828,1,0,chrIV
391782,392127,345,1,0,chrIV
397536,399129,1593,1,0,chrIV
399624,400638,1014,1,0,chrIV
404748,405060,312,1,0,chrIV
413952,414888,936,1,0,chrIV
429066,430926,1860,1,0,chrIV
439908,440754,846,1,0,chrIV
443028,443511,483,1,0,chrIV
461841,462516,675,1,0,chrIV
465918,470424,4506,1,0,chrIV
471852,472941,1089,1,0,chrIV
474045,475989,1944,1,0,chrIV
481902,482247,345,1,0,chrIV
489507,490896,1389,1,0,chrIV
491016,491502,486,1,0,chrIV
495804,496134,330,1,0,chrIV
496980,497298,318,1,0,chrIV
499323,499632,309,1,0,chrIV
499968,500403,435,1,0,chrIV
501099,501414,315,1,0,chrIV
508146,509109,963,1,0,chrIV
539802,540414,612,1,0,chrIV
551859,552948,1089,1,0,chrIV
563526,564861,1335,1,0,chrIV
565926,567555,1629,1,0,chrIV
570648,573726,3078,1,0,chrIV
579954,580452,498,1,0,chrIV
580686,581784,1098,1,0,chrIV
589983,590436,453,1,0,chrIV
593892,596583,2691,1,0,chrIV
598467,599688,1221,1,0,chrIV
600792,601809,1017,1,0,chrIV
603063,603399,336,1,0,chrIV
610440,611925,1485,1,0,chrIV
612015,613251,1236,1,0,chrIV
631281,636120,4839,1,0,chrIV
671268,673365,2097,1,0,chrIV
676101,677802,1701,1,0,chrIV
685881,687840,1959,1,0,chrIV
700314,701289,975,1,0,chrIV
703233,704244,1011,1,0,chrIV
709548,712995,3447,1,0,chrIV
737094,737469,375,1,0,chrIV
738699,739245,546,1,0,chrIV
765705,766503,798,1,0,chrIV
769524,769938,414,1,0,chrIV
771876,775782,3906,1,0,chrIV
781422,781950,528,1,0,chrIV
808323,810381,2058,1,0,chrIV
812109,812850,741,1,0,chrIV
819432,820824,1392,1,0,chrIV
829584,830277,693,1,0,chrIV
848598,850200,1602,1,0,chrIV
862053,864708,2655,1,0,chrIV
867084,867519,435,1,0,chrIV
873384,877425,4041,1,0,chrIV
907329,909438,2109,1,0,chrIV
910053,911301,1248,1,0,chrIV
916485,917154,669,1,0,chrIV
931128,933210,2082,1,0,chrIV
946806,948456,1650,1,0,chrIV
950562,952401,1839,1,0,chrIV
963411,963861,450,1,0,chrIV
965112,966489,1377,1,0,chrIV
982734,986775,4041,1,0,chrIV
1000446,1000749,303,1,0,chrIV
1010175,1011273,1098,1,0,chrIV
1012251,1012959,708,1,0,chrIV
1019367,1020420,1053,1,0,chrIV
1032435,1035063,2628,1,0,chrIV
1038390,1038762,372,1,0,chrIV
1050690,1051020,330,1,0,chrIV
1055211,1055892,681,1,0,chrIV
1067730,1068390,660,1,0,chrIV
1085064,1086993,1929,1,0,chrIV
1108701,1109847,1146,1,0,chrIV
1110588,1111692,1104,1,0,chrIV
1117125,1120233,3108,1,0,chrIV
1127871,1129374,1503,1,0,chrIV
1129587,1130823,1236,1,0,chrIV
1131000,1133070,2070,1,0,chrIV
1141167,1144842,3675,1,0,chrIV
1145091,1146036,945,1,0,chrIV
1146318,1147179,861,1,0,chrIV
1190058,1191732,1674,1,0,chrIV
1194597,1195032,435,1,0,chrIV
1198227,1198635,408,1,0,chrIV
1206996,1208319,1323,1,0,chrIV
1212459,1212771,312,1,0,chrIV
1212993,1213614,621,1,0,chrIV
1222758,1223331,573,1,0,chrIV
1237683,1238004,321,1,0,chrIV
1246083,1247982,1899,1,0,chrIV
1252536,1254501,1965,1,0,chrIV
1258695,1259709,1014,1,0,chrIV
1261680,1262967,1287,1,0,chrIV
1266294,1266795,501,1,0,chrIV
1267470,1269402,1932,1,0,chrIV
1272222,1272786,564,1,0,chrIV
1274601,1276212,1611,1,0,chrIV
1279209,1283799,4590,1,0,chrIV
1294692,1295400,708,1,0,chrIV
1303173,1305072,1899,1,0,chrIV
1306266,1311675,5409,1,0,chrIV
1320063,1321941,1878,1,0,chrIV
1334820,1336953,2133,1,0,chrIV
1338273,1339386,1113,1,0,chrIV
1367484,1369386,1902,1,0,chrIV
1383810,1384776,966,1,0,chrIV
1386072,1386516,444,1,0,chrIV
1388871,1393179,4308,1,0,chrIV
1395120,1397817,2697,1,0,chrIV
1399014,1399542,528,1,0,chrIV
1417398,1418370,972,1,0,chrIV
1422762,1424688,1926,1,0,chrIV
1425648,1426512,864,1,0,chrIV
1451352,1452918,1566,1,0,chrIV
1455219,1455534,315,1,0,chrIV
1478607,1480161,1554,1,0,chrIV
1483140,1483476,336,1,0,chrIV
1491093,1492413,1320,1,0,chrIV
1494585,1495857,1272,1,0,chrIV
1508004,1509714,1710,1,0,chrIV
1512093,1513605,1512,1,0,chrIV
1801,2953,1152,1,1,chrIV
18958,19312,354,1,1,chrIV
22822,25876,3054,1,1,chrIV
36796,38173,1377,1,1,chrIV
41725,42079,354,1,1,chrIV
52444,54100,1656,1,1,chrIV
67096,67399,303,1,1,chrIV
87460,87982,522,1,1,chrIV
90175,92464,2289,1,1,chrIV
116320,116866,546,1,1,chrIV
122215,123589,1374,1,1,chrIV
135895,137539,1644,1,1,chrIV
142096,144223,2127,1,1,chrIV
149332,149683,351,1,1,chrIV
149896,150211,315,1,1,chrIV
150277,150607,330,1,1,chrIV
167713,169078,1365,1,1,chrIV
172480,174028,1548,1,1,chrIV
178333,181039,2706,1,1,chrIV
181828,182230,402,1,1,chrIV
182821,183187,366,1,1,chrIV
184924,187918,2994,1,1,chrIV
203038,205111,2073,1,1,chrIV
227392,228715,1323,1,1,chrIV
232651,233887,1236,1,1,chrIV
241417,241840,423,1,1,chrIV
242551,244981,2430,1,1,chrIV
267922,268699,777,1,1,chrIV
276871,280165,3294,1,1,chrIV
282499,282814,315,1,1,chrIV
292780,293221,441,1,1,chrIV
305236,306577,1341,1,1,chrIV
311461,312037,576,1,1,chrIV
317221,317668,447,1,1,chrIV
333499,333829,330,1,1,chrIV
334834,336121,1287,1,1,chrIV
339856,340282,426,1,1,chrIV
345664,351037,5373,1,1,chrIV
351433,352420,987,1,1,chrIV
352876,355378,2502,1,1,chrIV
371239,371761,522,1,1,chrIV
374725,375034,309,1,1,chrIV
382582,382891,309,1,1,chrIV
383500,383803,303,1,1,chrIV
384796,385150,354,1,1,chrIV
392692,393037,345,1,1,chrIV
394216,397204,2988,1,1,chrIV
398617,398929,312,1,1,chrIV
411388,411688,300,1,1,chrIV
427363,428347,984,1,1,chrIV
438046,439360,1314,1,1,chrIV
444682,446383,1701,1,1,chrIV
455200,456583,1383,1,1,chrIV
477796,478285,489,1,1,chrIV
503497,503863,366,1,1,chrIV
521815,522928,1113,1,1,chrIV
525439,527215,1776,1,1,chrIV
528262,528568,306,1,1,chrIV
529792,530308,516,1,1,chrIV
532147,532453,306,1,1,chrIV
533677,534193,516,1,1,chrIV
536032,536338,306,1,1,chrIV
537562,538078,516,1,1,chrIV
542845,543217,372,1,1,chrIV
560248,560644,396,1,1,chrIV
573238,573709,471,1,1,chrIV
578662,579112,450,1,1,chrIV
592438,592948,510,1,1,chrIV
622111,624721,2610,1,1,chrIV
635839,636175,336,1,1,chrIV
637138,639823,2685,1,1,chrIV
655012,655444,432,1,1,chrIV
667003,667858,855,1,1,chrIV
679543,679852,309,1,1,chrIV
682174,682492,318,1,1,chrIV
694699,697894,3195,1,1,chrIV
715951,716302,351,1,1,chrIV
734137,734803,666,1,1,chrIV
746737,748357,1620,1,1,chrIV
751630,753235,1605,1,1,chrIV
769930,770332,402,1,1,chrIV
770356,771454,1098,1,1,chrIV
784870,786205,1335,1,1,chrIV
789448,790069,621,1,1,chrIV
790327,791848,1521,1,1,chrIV
803194,804517,1323,1,1,chrIV
806620,807748,1128,1,1,chrIV
811123,811513,390,1,1,chrIV
816877,817525,648,1,1,chrIV
827581,829057,1476,1,1,chrIV
851227,852397,1170,1,1,chrIV
858136,859144,1008,1,1,chrIV
859297,861520,2223,1,1,chrIV
889750,892492,2742,1,1,chrIV
900421,900871,450,1,1,chrIV
901690,902143,453,1,1,chrIV
902167,902560,393,1,1,chrIV
915529,915928,399,1,1,chrIV
924784,926146,1362,1,1,chrIV
927451,929098,1647,1,1,chrIV
960613,963106,2493,1,1,chrIV
993133,993952,819,1,1,chrIV
998863,999877,1014,1,1,chrIV
1009009,1009834,825,1,1,chrIV
1035994,1036873,879,1,1,chrIV
1037194,1038106,912,1,1,chrIV
1039369,1039699,330,1,1,chrIV
1056550,1057600,1050,1,1,chrIV
1063351,1067425,4074,1,1,chrIV
1075864,1077853,1989,1,1,chrIV
1093762,1095178,1416,1,1,chrIV
1096063,1097386,1323,1,1,chrIV
1102183,1103428,1245,1,1,chrIV
1106335,1106881,546,1,1,chrIV
1121092,1121404,312,1,1,chrIV
1125301,1125628,327,1,1,chrIV
1127074,1127584,510,1,1,chrIV
1134871,1135186,315,1,1,chrIV
1167382,1167841,459,1,1,chrIV
1178665,1181260,2595,1,1,chrIV
1181800,1182754,954,1,1,chrIV
1184746,1185889,1143,1,1,chrIV
1199182,1200553,1371,1,1,chrIV
1208797,1212265,3468,1,1,chrIV
1213903,1214842,939,1,1,chrIV
1216795,1217113,318,1,1,chrIV
1226821,1228303,1482,1,1,chrIV
1230166,1233196,3030,1,1,chrIV
1248754,1249072,318,1,1,chrIV
1250185,1251634,1449,1,1,chrIV
1270948,1272085,1137,1,1,chrIV
1298431,1301011,2580,1,1,chrIV
1307692,1308907,1215,1,1,chrIV
1312039,1314892,2853,1,1,chrIV
1324822,1325203,381,1,1,chrIV
1328389,1328701,312,1,1,chrIV
1328782,1330027,1245,1,1,chrIV
1331236,1332841,1605,1,1,chrIV
1339675,1340719,1044,1,1,chrIV
1342492,1344241,1749,1,1,chrIV
1344703,1345045,342,1,1,chrIV
1350289,1352353,2064,1,1,chrIV
1353724,1354633,909,1,1,chrIV
1356064,1357369,1305,1,1,chrIV
1362877,1364902,2025,1,1,chrIV
1369789,1379596,9807,1,1,chrIV
1405024,1405339,315,1,1,chrIV
1436929,1438015,1086,1,1,chrIV
1468225,1468573,348,1,1,chrIV
1470016,1470418,402,1,1,chrIV
1498231,1499335,1104,1,1,chrIV
1523248,1523611,363,1,1,chrIV
1526320,1531711,5391,1,1,chrIV
5984,7814,1830,1,2,chrIV
30656,31829,1173,1,2,chrIV
65393,65765,372,1,2,chrIV
78425,79058,633,1,2,chrIV
84269,85985,1716,1,2,chrIV
88247,89864,1617,1,2,chrIV
92849,93323,474,1,2,chrIV
94604,95786,1182,1,2,chrIV
96272,96581,309,1,2,chrIV
98474,99224,750,1,2,chrIV
99560,100421,861,1,2,chrIV
107207,111029,3822,1,2,chrIV
114671,115799,1128,1,2,chrIV
125615,126449,834,1,2,chrIV
133436,134723,1287,1,2,chrIV
138290,139205,915,1,2,chrIV
148190,149078,888,1,2,chrIV
156317,157904,1587,1,2,chrIV
161375,161780,405,1,2,chrIV
166955,167258,303,1,2,chrIV
174917,176486,1569,1,2,chrIV
192749,194225,1476,1,2,chrIV
213350,215642,2292,1,2,chrIV
224303,226751,2448,1,2,chrIV
231023,231899,876,1,2,chrIV
234926,235853,927,1,2,chrIV
247301,247682,381,1,2,chrIV
254024,254378,354,1,2,chrIV
258914,263225,4311,1,2,chrIV
283418,284444,1026,1,2,chrIV
296819,298274,1455,1,2,chrIV
301412,302234,822,1,2,chrIV
325283,325640,357,1,2,chrIV
326612,329567,2955,1,2,chrIV
341618,343985,2367,1,2,chrIV
369770,370706,936,1,2,chrIV
378101,378455,354,1,2,chrIV
393689,394001,312,1,2,chrIV
411824,413000,1176,1,2,chrIV
424208,425732,1524,1,2,chrIV
432329,433025,696,1,2,chrIV
433496,433994,498,1,2,chrIV
447983,449276,1293,1,2,chrIV
453044,453650,606,1,2,chrIV
454121,454754,633,1,2,chrIV
463433,464996,1563,1,2,chrIV
473156,473783,627,1,2,chrIV
486803,488003,1200,1,2,chrIV
488198,488528,330,1,2,chrIV
504296,504665,369,1,2,chrIV
515849,516164,315,1,2,chrIV
546641,547628,987,1,2,chrIV
553253,555152,1899,1,2,chrIV
574163,575783,1620,1,2,chrIV
576473,578159,1686,1,2,chrIV
583712,584645,933,1,2,chrIV
597155,598082,927,1,2,chrIV
604007,606986,2979,1,2,chrIV
614378,614705,327,1,2,chrIV
614816,615371,555,1,2,chrIV
641489,642083,594,1,2,chrIV
653606,654428,822,1,2,chrIV
658349,661103,2754,1,2,chrIV
688226,690533,2307,1,2,chrIV
693584,694175,591,1,2,chrIV
704483,709250,4767,1,2,chrIV
728258,730250,1992,1,2,chrIV
730577,732836,2259,1,2,chrIV
749729,750338,609,1,2,chrIV
755627,763874,8247,1,2,chrIV
776162,778721,2559,1,2,chrIV
779042,780206,1164,1,2,chrIV
804995,805688,693,1,2,chrIV
806747,807047,300,1,2,chrIV
814451,816560,2109,1,2,chrIV
817949,818495,546,1,2,chrIV
821294,825776,4482,1,2,chrIV
833243,833747,504,1,2,chrIV
836420,838061,1641,1,2,chrIV
838391,840392,2001,1,2,chrIV
842336,843449,1113,1,2,chrIV
844553,844952,399,1,2,chrIV
854174,854540,366,1,2,chrIV
856316,856814,498,1,2,chrIV
857681,857999,318,1,2,chrIV
868223,870563,2340,1,2,chrIV
872111,873428,1317,1,2,chrIV
884195,884552,357,1,2,chrIV
884726,886865,2139,1,2,chrIV
887231,888911,1680,1,2,chrIV
892874,893927,1053,1,2,chrIV
895034,899006,3972,1,2,chrIV
912098,913502,1404,1,2,chrIV
917570,921647,4077,1,2,chrIV
926222,926570,348,1,2,chrIV
933503,935138,1635,1,2,chrIV
936614,937493,879,1,2,chrIV
952799,953981,1182,1,2,chrIV
954287,954947,660,1,2,chrIV
956012,957398,1386,1,2,chrIV
981461,982778,1317,1,2,chrIV
1004003,1005143,1140,1,2,chrIV
1005674,1008689,3015,1,2,chrIV
1020746,1021664,918,1,2,chrIV
1039727,1042961,3234,1,2,chrIV
1059626,1061231,1605,1,2,chrIV
1087580,1088942,1362,1,2,chrIV
1097864,1101332,3468,1,2,chrIV
1104191,1104947,756,1,2,chrIV
1135931,1140476,4545,1,2,chrIV
1150880,1151183,303,1,2,chrIV
1169177,1170143,966,1,2,chrIV
1183298,1184258,960,1,2,chrIV
1186106,1188941,2835,1,2,chrIV
1219412,1220948,1536,1,2,chrIV
1228610,1228916,306,1,2,chrIV
1234217,1236125,1908,1,2,chrIV
1239491,1239824,333,1,2,chrIV
1243229,1245758,2529,1,2,chrIV
1259900,1261271,1371,1,2,chrIV
1263323,1266158,2835,1,2,chrIV
1270067,1270733,666,1,2,chrIV
1277645,1278437,792,1,2,chrIV
1289405,1292120,2715,1,2,chrIV
1301615,1302113,498,1,2,chrIV
1322204,1323386,1182,1,2,chrIV
1328834,1329206,372,1,2,chrIV
1329599,1330040,441,1,2,chrIV
1337351,1337774,423,1,2,chrIV
1345646,1346039,393,1,2,chrIV
1347878,1348577,699,1,2,chrIV
1386641,1388375,1734,1,2,chrIV
1400138,1400453,315,1,2,chrIV
1403321,1404173,852,1,2,chrIV
1412372,1414274,1902,1,2,chrIV
1414574,1415171,597,1,2,chrIV
1421156,1422485,1329,1,2,chrIV
1431011,1431896,885,1,2,chrIV
1434923,1435874,951,1,2,chrIV
1436216,1436588,372,1,2,chrIV
1441958,1442378,420,1,2,chrIV
1444124,1444427,303,1,2,chrIV
1447829,1450073,2244,1,2,chrIV
1469399,1469705,306,1,2,chrIV
1471016,1471448,432,1,2,chrIV
1473428,1474772,1344,1,2,chrIV
1477238,1478357,1119,1,2,chrIV
1480424,1480832,408,1,2,chrIV
1489904,1490234,330,1,2,chrIV
1499420,1499720,300,1,2,chrIV
1510901,1511630,729,1,2,chrIV
1530047,1530623,576,1,2,chrIV
1530862,1531345,483,-1,0,chrIV
1529986,1530562,576,-1,0,chrIV
1527478,1527829,351,-1,0,chrIV
1519663,1520698,1035,-1,0,chrIV
1510855,1511461,606,-1,0,chrIV
1503313,1504900,1587,-1,0,chrIV
1499395,1500553,1158,-1,0,chrIV
1496164,1496548,384,-1,0,chrIV
1485565,1487038,1473,-1,0,chrIV
1477561,1477861,300,-1,0,chrIV
1470499,1471063,564,-1,0,chrIV
1466452,1468444,1992,-1,0,chrIV
1462357,1465786,3429,-1,0,chrIV
1453309,1454464,1155,-1,0,chrIV
1445842,1446994,1152,-1,0,chrIV
1443712,1445467,1755,-1,0,chrIV
1441432,1443403,1971,-1,0,chrIV
1438114,1441150,3036,-1,0,chrIV
1434499,1434991,492,-1,0,chrIV
1431967,1434268,2301,-1,0,chrIV
1415209,1416874,1665,-1,0,chrIV
1407463,1410094,2631,-1,0,chrIV
1399705,1401214,1509,-1,0,chrIV
1398025,1398700,675,-1,0,chrIV
1386937,1387297,360,-1,0,chrIV
1361119,1362181,1062,-1,0,chrIV
1357579,1358902,1323,-1,0,chrIV
1345675,1349938,4263,-1,0,chrIV
1332982,1333969,987,-1,0,chrIV
1325500,1328470,2970,-1,0,chrIV
1318045,1319275,1230,-1,0,chrIV
1307422,1308610,1188,-1,0,chrIV
1301554,1301926,372,-1,0,chrIV
1297036,1298161,1125,-1,0,chrIV
1292371,1293091,720,-1,0,chrIV
1265752,1266091,339,-1,0,chrIV
1264438,1264873,435,-1,0,chrIV
1260541,1261165,624,-1,0,chrIV
1241203,1242031,828,-1,0,chrIV
1225165,1226536,1371,-1,0,chrIV
1223473,1224394,921,-1,0,chrIV
1202842,1204210,1368,-1,0,chrIV
1195411,1196263,852,-1,0,chrIV
1189198,1189567,369,-1,0,chrIV
1186066,1186369,303,-1,0,chrIV
1170325,1171825,1500,-1,0,chrIV
1169527,1169854,327,-1,0,chrIV
1154215,1155928,1713,-1,0,chrIV
1147378,1149466,2088,-1,0,chrIV
1137313,1137661,348,-1,0,chrIV
1136590,1136926,336,-1,0,chrIV
1125433,1126018,585,-1,0,chrIV
1114432,1116763,2331,-1,0,chrIV
1112479,1114027,1548,-1,0,chrIV
1090432,1092511,2079,-1,0,chrIV
1079047,1080199,1152,-1,0,chrIV
1073734,1075171,1437,-1,0,chrIV
1045639,1049392,3753,-1,0,chrIV
1030549,1031419,870,-1,0,chrIV
1014400,1015702,1302,-1,0,chrIV
1008394,1008766,372,-1,0,chrIV
1005664,1005988,324,-1,0,chrIV
996028,998323,2295,-1,0,chrIV
966556,967822,1266,-1,0,chrIV
957757,958339,582,-1,0,chrIV
948517,950284,1767,-1,0,chrIV
941056,943420,2364,-1,0,chrIV
937894,940816,2922,-1,0,chrIV
921925,923806,1881,-1,0,chrIV
920182,920671,489,-1,0,chrIV
894088,894502,414,-1,0,chrIV
882604,883927,1323,-1,0,chrIV
864118,864577,459,-1,0,chrIV
856897,857953,1056,-1,0,chrIV
854278,856093,1815,-1,0,chrIV
852532,853972,1440,-1,0,chrIV
850273,850999,726,-1,0,chrIV
843568,844861,1293,-1,0,chrIV
838858,839209,351,-1,0,chrIV
836746,837091,345,-1,0,chrIV
836227,836746,519,-1,0,chrIV
832858,835492,2634,-1,0,chrIV
821593,822421,828,-1,0,chrIV
818707,819196,489,-1,0,chrIV
796192,802222,6030,-1,0,chrIV
768511,769000,489,-1,0,chrIV
766735,767971,1236,-1,0,chrIV
759598,759904,306,-1,0,chrIV
755554,756262,708,-1,0,chrIV
748612,750742,2130,-1,0,chrIV
744310,746101,1791,-1,0,chrIV
729112,729415,303,-1,0,chrIV
720961,721297,336,-1,0,chrIV
688495,688888,393,-1,0,chrIV
682723,683581,858,-1,0,chrIV
673519,675667,2148,-1,0,chrIV
640108,643837,3729,-1,0,chrIV
626707,628534,1827,-1,0,chrIV
618496,619645,1149,-1,0,chrIV
614287,616150,1863,-1,0,chrIV
607303,610081,2778,-1,0,chrIV
602197,602869,672,-1,0,chrIV
588826,589402,576,-1,0,chrIV
584938,587719,2781,-1,0,chrIV
582790,583465,675,-1,0,chrIV
574489,574822,333,-1,0,chrIV
569233,569566,333,-1,0,chrIV
561439,562327,888,-1,0,chrIV
548761,550576,1815,-1,0,chrIV
526084,526441,357,-1,0,chrIV
523210,524713,1503,-1,0,chrIV
514042,518083,4041,-1,0,chrIV
488071,488662,591,-1,0,chrIV
484162,485365,1203,-1,0,chrIV
456835,457552,717,-1,0,chrIV
441013,442309,1296,-1,0,chrIV
432307,432631,324,-1,0,chrIV
426001,426934,933,-1,0,chrIV
425569,425872,303,-1,0,chrIV
411760,412081,321,-1,0,chrIV
405343,407206,1863,-1,0,chrIV
400996,403291,2295,-1,0,chrIV
376756,378445,1689,-1,0,chrIV
375679,376480,801,-1,0,chrIV
373966,375289,1323,-1,0,chrIV
362671,363583,912,-1,0,chrIV
359824,361285,1461,-1,0,chrIV
344236,344953,717,-1,0,chrIV
335011,335467,456,-1,0,chrIV
324046,326149,2103,-1,0,chrIV
301654,302089,435,-1,0,chrIV
295033,296329,1296,-1,0,chrIV
280306,281848,1542,-1,0,chrIV
273652,274876,1224,-1,0,chrIV
264511,264964,453,-1,0,chrIV
262435,262870,435,-1,0,chrIV
246688,247612,924,-1,0,chrIV
245956,246328,372,-1,0,chrIV
219661,220771,1110,-1,0,chrIV
201718,202570,852,-1,0,chrIV
198661,199741,1080,-1,0,chrIV
164986,167254,2268,-1,0,chrIV
148606,149086,480,-1,0,chrIV
145825,147589,1764,-1,0,chrIV
141208,141721,513,-1,0,chrIV
130870,131833,963,-1,0,chrIV
103648,104551,903,-1,0,chrIV
100114,100414,300,-1,0,chrIV
92761,93745,984,-1,0,chrIV
86206,87226,1020,-1,0,chrIV
70639,73918,3279,-1,0,chrIV
60871,61801,930,-1,0,chrIV
46270,48031,1761,-1,0,chrIV
38866,42244,3378,-1,0,chrIV
28984,30454,1470,-1,0,chrIV
11656,13360,1704,-1,0,chrIV
1530069,1530576,507,-1,1,chrIV
1529364,1529700,336,-1,1,chrIV
1524633,1524933,300,-1,1,chrIV
1503630,1504170,540,-1,1,chrIV
1501446,1502160,714,-1,1,chrIV
1496790,1497768,978,-1,1,chrIV
1487541,1488990,1449,-1,1,chrIV
1483794,1485303,1509,-1,1,chrIV
1427430,1428219,789,-1,1,chrIV
1404444,1405854,1410,-1,1,chrIV
1393335,1394574,1239,-1,1,chrIV
1380054,1382046,1992,-1,1,chrIV
1366263,1366827,564,-1,1,chrIV
1363233,1363572,339,-1,1,chrIV
1352181,1352589,408,-1,1,chrIV
1344516,1345062,546,-1,1,chrIV
1342803,1343130,327,-1,1,chrIV
1340142,1340535,393,-1,1,chrIV
1324476,1325301,825,-1,1,chrIV
1323453,1324239,786,-1,1,chrIV
1312101,1312494,393,-1,1,chrIV
1276653,1277169,516,-1,1,chrIV
1257357,1258056,699,-1,1,chrIV
1254936,1256847,1911,-1,1,chrIV
1248153,1249821,1668,-1,1,chrIV
1227966,1228299,333,-1,1,chrIV
1221111,1222149,1038,-1,1,chrIV
1217781,1219110,1329,-1,1,chrIV
1215015,1217580,2565,-1,1,chrIV
1178754,1179294,540,-1,1,chrIV
1172385,1174176,1791,-1,1,chrIV
1167213,1168659,1446,-1,1,chrIV
1162956,1164660,1704,-1,1,chrIV
1162005,1162449,444,-1,1,chrIV
1151802,1153626,1824,-1,1,chrIV
1133259,1135431,2172,-1,1,chrIV
1126269,1127595,1326,-1,1,chrIV
1120608,1124925,4317,-1,1,chrIV
1106094,1108101,2007,-1,1,chrIV
1105002,1105827,825,-1,1,chrIV
1078026,1078449,423,-1,1,chrIV
1071879,1072557,678,-1,1,chrIV
1058175,1058814,639,-1,1,chrIV
1052622,1054647,2025,-1,1,chrIV
1043145,1045011,1866,-1,1,chrIV
1038279,1039509,1230,-1,1,chrIV
1023510,1024755,1245,-1,1,chrIV
1017000,1017318,318,-1,1,chrIV
1011588,1011960,372,-1,1,chrIV
991026,992349,1323,-1,1,chrIV
977520,979209,1689,-1,1,chrIV
976716,977229,513,-1,1,chrIV
958680,959802,1122,-1,1,chrIV
935235,935892,657,-1,1,chrIV
929469,930357,888,-1,1,chrIV
926292,926910,618,-1,1,chrIV
914316,914712,396,-1,1,chrIV
905454,906852,1398,-1,1,chrIV
903780,905052,1272,-1,1,chrIV
899550,903480,3930,-1,1,chrIV
891228,891579,351,-1,1,chrIV
878658,882126,3468,-1,1,chrIV
871035,871449,414,-1,1,chrIV
865011,867522,2511,-1,1,chrIV
843810,844281,471,-1,1,chrIV
840603,841995,1392,-1,1,chrIV
831933,832473,540,-1,1,chrIV
830628,831513,885,-1,1,chrIV
825909,827355,1446,-1,1,chrIV
813192,814152,960,-1,1,chrIV
810564,811632,1068,-1,1,chrIV
801549,801972,423,-1,1,chrIV
790506,790854,348,-1,1,chrIV
785763,786102,339,-1,1,chrIV
785022,785364,342,-1,1,chrIV
782040,784215,2175,-1,1,chrIV
768402,768753,351,-1,1,chrIV
742041,743874,1833,-1,1,chrIV
740472,741600,1128,-1,1,chrIV
727710,728283,573,-1,1,chrIV
723003,727551,4548,-1,1,chrIV
718815,720303,1488,-1,1,chrIV
715746,716622,876,-1,1,chrIV
698553,699468,915,-1,1,chrIV
691548,693261,1713,-1,1,chrIV
678240,679764,1524,-1,1,chrIV
669015,671034,2019,-1,1,chrIV
667824,668139,315,-1,1,chrIV
649803,651126,1323,-1,1,chrIV
638385,638703,318,-1,1,chrIV
625065,625998,933,-1,1,chrIV
622545,623139,594,-1,1,chrIV
617469,618306,837,-1,1,chrIV
613404,614004,600,-1,1,chrIV
581907,582498,591,-1,1,chrIV
558510,560625,2115,-1,1,chrIV
557055,558060,1005,-1,1,chrIV
553083,553398,315,-1,1,chrIV
547977,548310,333,-1,1,chrIV
542673,543369,696,-1,1,chrIV
540600,541203,603,-1,1,chrIV
535191,538467,3276,-1,1,chrIV
531306,534582,3276,-1,1,chrIV
527421,530697,3276,-1,1,chrIV
509736,512109,2373,-1,1,chrIV
503568,503895,327,-1,1,chrIV
492555,494268,1713,-1,1,chrIV
485745,486444,699,-1,1,chrIV
458541,461247,2706,-1,1,chrIV
450219,452475,2256,-1,1,chrIV
432924,433248,324,-1,1,chrIV
422832,423510,678,-1,1,chrIV
408450,409857,1407,-1,1,chrIV
392658,393912,1254,-1,1,chrIV
384600,385587,987,-1,1,chrIV
381984,384081,2097,-1,1,chrIV
378873,381438,2565,-1,1,chrIV
372687,373608,921,-1,1,chrIV
366738,368211,1473,-1,1,chrIV
365067,365874,807,-1,1,chrIV
361698,362256,558,-1,1,chrIV
349749,350247,498,-1,1,chrIV
338271,340134,1863,-1,1,chrIV
333120,333822,702,-1,1,chrIV
329835,330447,612,-1,1,chrIV
320667,321552,885,-1,1,chrIV
314253,314748,495,-1,1,chrIV
310641,312471,1830,-1,1,chrIV
309801,310122,321,-1,1,chrIV
300213,300999,786,-1,1,chrIV
298416,300003,1587,-1,1,chrIV
293391,294759,1368,-1,1,chrIV
285390,286695,1305,-1,1,chrIV
284580,285165,585,-1,1,chrIV
282111,283176,1065,-1,1,chrIV
265257,267201,1944,-1,1,chrIV
256632,258555,1923,-1,1,chrIV
218679,219288,609,-1,1,chrIV
211374,212118,744,-1,1,chrIV
205359,210561,5202,-1,1,chrIV
184956,185382,426,-1,1,chrIV
181185,183018,1833,-1,1,chrIV
174231,174588,357,-1,1,chrIV
173865,174174,309,-1,1,chrIV
170409,171930,1521,-1,1,chrIV
167358,167715,357,-1,1,chrIV
149202,155640,6438,-1,1,chrIV
144483,145518,1035,-1,1,chrIV
126834,127242,408,-1,1,chrIV
125508,125838,330,-1,1,chrIV
123864,124998,1134,-1,1,chrIV
104916,106494,1578,-1,1,chrIV
101289,103353,2064,-1,1,chrIV
100500,101121,621,-1,1,chrIV
96081,97953,1872,-1,1,chrIV
79293,80412,1119,-1,1,chrIV
74445,76545,2100,-1,1,chrIV
57264,60405,3141,-1,1,chrIV
54396,56346,1950,-1,1,chrIV
51114,52173,1059,-1,1,chrIV
45276,45918,642,-1,1,chrIV
34236,36477,2241,-1,1,chrIV
33414,33918,504,-1,1,chrIV
24885,25197,312,-1,1,chrIV
8682,9756,1074,-1,1,chrIV
1525094,1525523,429,-1,2,chrIV
1517135,1517675,540,-1,2,chrIV
1497086,1497395,309,-1,2,chrIV
1491074,1491545,471,-1,2,chrIV
1481084,1483403,2319,-1,2,chrIV
1474973,1476476,1503,-1,2,chrIV
1471547,1472999,1452,-1,2,chrIV
1459727,1461554,1827,-1,2,chrIV
1456694,1459220,2526,-1,2,chrIV
1456310,1456694,384,-1,2,chrIV
1455041,1455866,825,-1,2,chrIV
1443755,1444070,315,-1,2,chrIV
1429187,1430789,1602,-1,2,chrIV
1428353,1428980,627,-1,2,chrIV
1424819,1427252,2433,-1,2,chrIV
1420430,1420838,408,-1,2,chrIV
1418549,1420250,1701,-1,2,chrIV
1410452,1411127,675,-1,2,chrIV
1397582,1397909,327,-1,2,chrIV
1395857,1396217,360,-1,2,chrIV
1391573,1392305,732,-1,2,chrIV
1384214,1384655,441,-1,2,chrIV
1382318,1383443,1125,-1,2,chrIV
1367372,1367681,309,-1,2,chrIV
1365071,1365662,591,-1,2,chrIV
1321628,1322006,378,-1,2,chrIV
1315325,1317917,2592,-1,2,chrIV
1306328,1306628,300,-1,2,chrIV
1301723,1302062,339,-1,2,chrIV
1295597,1296686,1089,-1,2,chrIV
1294835,1295411,576,-1,2,chrIV
1293368,1294394,1026,-1,2,chrIV
1288214,1288859,645,-1,2,chrIV
1284068,1287938,3870,-1,2,chrIV
1272233,1273703,1470,-1,2,chrIV
1266365,1266779,414,-1,2,chrIV
1258808,1259258,450,-1,2,chrIV
1256060,1256402,342,-1,2,chrIV
1239959,1240718,759,-1,2,chrIV
1229348,1229720,372,-1,2,chrIV
1212437,1212836,399,-1,2,chrIV
1204496,1206383,1887,-1,2,chrIV
1196678,1198697,2019,-1,2,chrIV
1191935,1194884,2949,-1,2,chrIV
1176119,1178174,2055,-1,2,chrIV
1159607,1161320,1713,-1,2,chrIV
1149950,1150520,570,-1,2,chrIV
1128740,1129082,342,-1,2,chrIV
1128296,1128596,300,-1,2,chrIV
1118423,1119113,690,-1,2,chrIV
1092740,1093586,846,-1,2,chrIV
1089218,1090079,861,-1,2,chrIV
1081127,1084316,3189,-1,2,chrIV
1072745,1073207,462,-1,2,chrIV
1068728,1071386,2658,-1,2,chrIV
1061504,1062791,1287,-1,2,chrIV
1050458,1052228,1770,-1,2,chrIV
1035230,1035575,345,-1,2,chrIV
1025069,1030049,4980,-1,2,chrIV
1022006,1022321,315,-1,2,chrIV
1002509,1003502,993,-1,2,chrIV
1000103,1002023,1920,-1,2,chrIV
994241,995534,1293,-1,2,chrIV
987533,990548,3015,-1,2,chrIV
984653,984968,315,-1,2,chrIV
974630,975782,1152,-1,2,chrIV
971807,974243,2436,-1,2,chrIV
969989,971474,1485,-1,2,chrIV
968132,969680,1548,-1,2,chrIV
963989,964565,576,-1,2,chrIV
943673,945152,1479,-1,2,chrIV
875303,875618,315,-1,2,chrIV
866696,867086,390,-1,2,chrIV
866024,866381,357,-1,2,chrIV
849116,849713,597,-1,2,chrIV
845951,847946,1995,-1,2,chrIV
806936,807344,408,-1,2,chrIV
792347,793889,1542,-1,2,chrIV
786305,789221,2916,-1,2,chrIV
780389,781100,711,-1,2,chrIV
764177,765155,978,-1,2,chrIV
753674,755066,1392,-1,2,chrIV
743057,743444,387,-1,2,chrIV
734900,739997,5097,-1,2,chrIV
716789,718460,1671,-1,2,chrIV
713339,714233,894,-1,2,chrIV
701396,702758,1362,-1,2,chrIV
700586,700970,384,-1,2,chrIV
683945,685643,1698,-1,2,chrIV
681923,682226,303,-1,2,chrIV
680495,681617,1122,-1,2,chrIV
665348,666770,1422,-1,2,chrIV
661172,664910,3738,-1,2,chrIV
657647,657980,333,-1,2,chrIV
655685,657467,1782,-1,2,chrIV
645857,649325,3468,-1,2,chrIV
644177,645035,858,-1,2,chrIV
636116,636527,411,-1,2,chrIV
634499,634820,321,-1,2,chrIV
589760,591344,1584,-1,2,chrIV
567722,568703,981,-1,2,chrIV
565022,565640,618,-1,2,chrIV
563960,564272,312,-1,2,chrIV
563648,563960,312,-1,2,chrIV
555725,556472,747,-1,2,chrIV
552479,552779,300,-1,2,chrIV
536843,537203,360,-1,2,chrIV
532958,533318,360,-1,2,chrIV
529073,529433,360,-1,2,chrIV
518039,519356,1317,-1,2,chrIV
504098,504695,597,-1,2,chrIV
501752,503273,1521,-1,2,chrIV
497834,500879,3045,-1,2,chrIV
494648,497318,2670,-1,2,chrIV
482669,483860,1191,-1,2,chrIV
479114,482267,3153,-1,2,chrIV
465050,465383,333,-1,2,chrIV
462251,462602,351,-1,2,chrIV
446966,447578,612,-1,2,chrIV
417662,421514,3852,-1,2,chrIV
415112,416708,1596,-1,2,chrIV
403694,404957,1263,-1,2,chrIV
400121,400571,450,-1,2,chrIV
389171,392057,2886,-1,2,chrIV
387512,388901,1389,-1,2,chrIV
384818,385346,528,-1,2,chrIV
370361,370676,315,-1,2,chrIV
364445,364817,372,-1,2,chrIV
355673,356759,1086,-1,2,chrIV
336248,337301,1053,-1,2,chrIV
330665,331040,375,-1,2,chrIV
316970,320120,3150,-1,2,chrIV
315356,316388,1032,-1,2,chrIV
312950,314078,1128,-1,2,chrIV
289571,290081,510,-1,2,chrIV
286997,287324,327,-1,2,chrIV
275147,276581,1434,-1,2,chrIV
270221,271901,1680,-1,2,chrIV
263312,264110,798,-1,2,chrIV
253994,254717,723,-1,2,chrIV
250580,250916,336,-1,2,chrIV
245132,245582,450,-1,2,chrIV
236156,238664,2508,-1,2,chrIV
205151,206060,909,-1,2,chrIV
200045,200354,309,-1,2,chrIV
194570,198176,3606,-1,2,chrIV
188153,190586,2433,-1,2,chrIV
183317,183899,582,-1,2,chrIV
163448,164042,594,-1,2,chrIV
160994,163154,2160,-1,2,chrIV
159557,159857,300,-1,2,chrIV
158063,158735,672,-1,2,chrIV
118706,121592,2886,-1,2,chrIV
77288,77966,678,-1,2,chrIV
68996,70364,1368,-1,2,chrIV
67982,68606,624,-1,2,chrIV
62243,65018,2775,-1,2,chrIV
61115,61463,348,-1,2,chrIV
58286,58631,345,-1,2,chrIV
57311,57665,354,-1,2,chrIV
26402,28775,2373,-1,2,chrIV
17576,18566,990,-1,2,chrIV
1398,2073,675,1,0,chrV
2442,2778,336,1,0,chrV
4332,4641,309,1,0,chrV
4869,5481,612,1,0,chrV
13719,14415,696,1,0,chrV
40149,40542,393,1,0,chrV
42651,42960,309,1,0,chrV
43251,44925,1674,1,0,chrV
49221,49731,510,1,0,chrV
58377,59148,771,1,0,chrV
69756,70257,501,1,0,chrV
73770,75327,1557,1,0,chrV
86178,86598,420,1,0,chrV
98667,99129,462,1,0,chrV
107259,107907,648,1,0,chrV
111420,115800,4380,1,0,chrV
116166,116970,804,1,0,chrV
121470,122310,840,1,0,chrV
123876,124185,309,1,0,chrV
133119,135234,2115,1,0,chrV
136278,136629,351,1,0,chrV
139380,139752,372,1,0,chrV
140511,140892,381,1,0,chrV
141891,143892,2001,1,0,chrV
148227,148599,372,1,0,chrV
153519,155808,2289,1,0,chrV
159579,160275,696,1,0,chrV
164526,166083,1557,1,0,chrV
177834,178431,597,1,0,chrV
196947,198519,1572,1,0,chrV
201075,201936,861,1,0,chrV
202191,204963,2772,1,0,chrV
219732,220065,333,1,0,chrV
225888,226854,966,1,0,chrV
228450,228831,381,1,0,chrV
229794,231987,2193,1,0,chrV
234936,235491,555,1,0,chrV
243699,244029,330,1,0,chrV
251727,253662,1935,1,0,chrV
254655,256134,1479,1,0,chrV
271767,272091,324,1,0,chrV
274566,276153,1587,1,0,chrV
278850,279219,369,1,0,chrV
281709,282366,657,1,0,chrV
290241,290799,558,1,0,chrV
292065,292551,486,1,0,chrV
293049,294813,1764,1,0,chrV
302805,303195,390,1,0,chrV
304029,305592,1563,1,0,chrV
313389,313737,348,1,0,chrV
319962,321846,1884,1,0,chrV
327597,328110,513,1,0,chrV
328476,330207,1731,1,0,chrV
343725,344028,303,1,0,chrV
344409,344901,492,1,0,chrV
363099,363702,603,1,0,chrV
366801,367428,627,1,0,chrV
387231,387795,564,1,0,chrV
397305,397653,348,1,0,chrV
413664,414084,420,1,0,chrV
414480,415554,1074,1,0,chrV
423951,424311,360,1,0,chrV
437190,437532,342,1,0,chrV
456318,457605,1287,1,0,chrV
468369,468816,447,1,0,chrV
473484,474051,567,1,0,chrV
510372,512106,1734,1,0,chrV
523368,525759,2391,1,0,chrV
534741,535116,375,1,0,chrV
541689,545055,3366,1,0,chrV
545610,546414,804,1,0,chrV
546747,548079,1332,1,0,chrV
566229,566655,426,1,0,chrV
571479,576525,5046,1,0,chrV
16354,17845,1491,1,1,chrV
19588,21097,1509,1,1,chrV
41584,41917,333,1,1,chrV
47167,48373,1206,1,1,chrV
63727,64090,363,1,1,chrV
70477,73348,2871,1,1,chrV
75943,77431,1488,1,1,chrV
78052,79456,1404,1,1,chrV
80419,81145,726,1,1,chrV
85675,86149,474,1,1,chrV
100768,101251,483,1,1,chrV
126628,128284,1656,1,1,chrV
128824,130561,1737,1,1,chrV
146950,147979,1029,1,1,chrV
156802,157498,696,1,1,chrV
160549,162442,1893,1,1,chrV
172114,172492,378,1,1,chrV
178840,182278,3438,1,1,chrV
182599,184219,1620,1,1,chrV
184540,186775,2235,1,1,chrV
192796,194230,1434,1,1,chrV
198811,200875,2064,1,1,chrV
213415,213898,483,1,1,chrV
214915,217693,2778,1,1,chrV
221845,222403,558,1,1,chrV
267778,268090,312,1,1,chrV
272623,273886,1263,1,1,chrV
276571,278164,1593,1,1,chrV
318919,319552,633,1,1,chrV
327064,327451,387,1,1,chrV
337948,339472,1524,1,1,chrV
351697,353236,1539,1,1,chrV
355465,357730,2265,1,1,chrV
364588,366517,1929,1,1,chrV
372325,373234,909,1,1,chrV
384691,385003,312,1,1,chrV
401134,401869,735,1,1,chrV
404812,406387,1575,1,1,chrV
410188,412618,2430,1,1,chrV
415858,416470,612,1,1,chrV
417280,420709,3429,1,1,chrV
439615,440971,1356,1,1,chrV
441574,441880,306,1,1,chrV
451564,453235,1671,1,1,chrV
454567,454870,303,1,1,chrV
455179,455536,357,1,1,chrV
460945,461575,630,1,1,chrV
472942,473296,354,1,1,chrV
483400,483718,318,1,1,chrV
501661,502042,381,1,1,chrV
512743,517459,4716,1,1,chrV
518215,520771,2556,1,1,chrV
525973,526651,678,1,1,chrV
536299,538279,1980,1,1,chrV
548845,549517,672,1,1,chrV
559453,560365,912,1,1,chrV
568039,568759,720,1,1,chrV
574864,575440,576,1,1,chrV
629,1112,483,1,2,chrV
1412,2156,744,1,2,chrV
6125,6464,339,1,2,chrV
26666,27206,540,1,2,chrV
27656,29543,1887,1,2,chrV
33026,33395,369,1,2,chrV
34379,36254,1875,1,2,chrV
52907,53255,348,1,2,chrV
56570,58100,1530,1,2,chrV
73007,73313,306,1,2,chrV
78719,79061,342,1,2,chrV
86936,89852,2916,1,2,chrV
90257,93905,3648,1,2,chrV
94643,96578,1935,1,2,chrV
101942,102323,381,1,2,chrV
123656,124670,1014,1,2,chrV
131930,132551,621,1,2,chrV
144326,145334,1008,1,2,chrV
162722,164285,1563,1,2,chrV
175247,176012,765,1,2,chrV
188276,189311,1035,1,2,chrV
195167,196517,1350,1,2,chrV
205250,206834,1584,1,2,chrV
222638,223076,438,1,2,chrV
232460,234740,2280,1,2,chrV
243179,243611,432,1,2,chrV
295409,298001,2592,1,2,chrV
298949,301616,2667,1,2,chrV
314582,314984,402,1,2,chrV
322685,324095,1410,1,2,chrV
330575,332306,1731,1,2,chrV
333203,333713,510,1,2,chrV
342854,343232,378,1,2,chrV
349979,351182,1203,1,2,chrV
355139,355469,330,1,2,chrV
359561,360314,753,1,2,chrV
374393,374714,321,1,2,chrV
382643,382988,345,1,2,chrV
391694,391997,303,1,2,chrV
393086,393407,321,1,2,chrV
402374,402719,345,1,2,chrV
408209,408563,354,1,2,chrV
433529,433958,429,1,2,chrV
453458,454919,1461,1,2,chrV
465302,466025,723,1,2,chrV
466184,466763,579,1,2,chrV
475019,476228,1209,1,2,chrV
484787,487193,2406,1,2,chrV
501059,501452,393,1,2,chrV
505391,509798,4407,1,2,chrV
527081,529418,2337,1,2,chrV
552524,553259,735,1,2,chrV
571154,571523,369,1,2,chrV
566233,566560,327,-1,0,chrV
553333,553969,636,-1,0,chrV
528127,528535,408,-1,0,chrV
512626,512983,357,-1,0,chrV
503083,503782,699,-1,0,chrV
500629,502894,2265,-1,0,chrV
496801,498124,1323,-1,0,chrV
476344,482848,6504,-1,0,chrV
474040,474805,765,-1,0,chrV
466207,467470,1263,-1,0,chrV
465202,465613,411,-1,0,chrV
462967,464842,1875,-1,0,chrV
462385,462823,438,-1,0,chrV
460525,461740,1215,-1,0,chrV
450562,451243,681,-1,0,chrV
443755,447223,3468,-1,0,chrV
437266,437803,537,-1,0,chrV
421114,422446,1332,-1,0,chrV
407341,409063,1722,-1,0,chrV
401224,401716,492,-1,0,chrV
397951,399055,1104,-1,0,chrV
395347,396172,825,-1,0,chrV
394291,394867,576,-1,0,chrV
390589,393712,3123,-1,0,chrV
387931,390052,2121,-1,0,chrV
382594,385876,3282,-1,0,chrV
377188,377614,426,-1,0,chrV
375214,376999,1785,-1,0,chrV
373447,374545,1098,-1,0,chrV
367837,372013,4176,-1,0,chrV
335695,336019,324,-1,0,chrV
333175,335188,2013,-1,0,chrV
331816,332368,552,-1,0,chrV
326173,327097,924,-1,0,chrV
324271,325936,1665,-1,0,chrV
314533,316600,2067,-1,0,chrV
312589,313498,909,-1,0,chrV
295300,295732,432,-1,0,chrV
270736,271126,390,-1,0,chrV
262051,263698,1647,-1,0,chrV
258736,259639,903,-1,0,chrV
240031,241501,1470,-1,0,chrV
234094,234571,477,-1,0,chrV
223366,225199,1833,-1,0,chrV
218056,221287,3231,-1,0,chrV
214075,214747,672,-1,0,chrV
210691,211876,1185,-1,0,chrV
208978,210232,1254,-1,0,chrV
207643,208474,831,-1,0,chrV
195310,195646,336,-1,0,chrV
189502,191788,2286,-1,0,chrV
183730,184063,333,-1,0,chrV
175471,175885,414,-1,0,chrV
172633,173338,705,-1,0,chrV
157735,158878,1143,-1,0,chrV
145906,146755,849,-1,0,chrV
132067,132505,438,-1,0,chrV
128302,128608,306,-1,0,chrV
102580,106147,3567,-1,0,chrV
94582,94897,315,-1,0,chrV
91015,91360,345,-1,0,chrV
88048,88393,345,-1,0,chrV
87694,88012,318,-1,0,chrV
85612,86215,603,-1,0,chrV
81406,82603,1197,-1,0,chrV
80536,80881,345,-1,0,chrV
78682,79096,414,-1,0,chrV
68839,69265,426,-1,0,chrV
64708,65167,459,-1,0,chrV
52720,53218,498,-1,0,chrV
45019,45721,702,-1,0,chrV
40045,41953,1908,-1,0,chrV
31693,33466,1773,-1,0,chrV
28159,28654,495,-1,0,chrV
26188,26776,588,-1,0,chrV
25645,25978,333,-1,0,chrV
5344,5713,369,-1,0,chrV
1351,2095,744,-1,0,chrV
575679,576162,483,-1,1,chrV
574803,575379,576,-1,1,chrV
572295,572646,351,-1,1,chrV
569607,569907,300,-1,1,chrV
551472,551796,324,-1,1,chrV
549723,550527,804,-1,1,chrV
539463,540363,900,-1,1,chrV
536274,536655,381,-1,1,chrV
521028,522669,1641,-1,1,chrV
510726,511179,453,-1,1,chrV
492855,496323,3468,-1,1,chrV
491529,491958,429,-1,1,chrV
488856,490578,1722,-1,1,chrV
483324,484341,1017,-1,1,chrV
472656,473988,1332,-1,1,chrV
455145,456036,891,-1,1,chrV
441372,441819,447,-1,1,chrV
425187,430449,5262,-1,1,chrV
418101,418605,504,-1,1,chrV
402870,404352,1482,-1,1,chrV
400866,401238,372,-1,1,chrV
399495,400842,1347,-1,1,chrV
360501,361794,1293,-1,1,chrV
358104,359061,957,-1,1,chrV
327618,328140,522,-1,1,chrV
316806,318342,1536,-1,1,chrV
308412,311199,2787,-1,1,chrV
292239,292563,324,-1,1,chrV
291702,292203,501,-1,1,chrV
285240,286914,1674,-1,1,chrV
266511,268113,1602,-1,1,chrV
264891,265785,894,-1,1,chrV
256374,257958,1584,-1,1,chrV
246981,248157,1176,-1,1,chrV
226857,228252,1395,-1,1,chrV
215859,216180,321,-1,1,chrV
212586,213177,591,-1,1,chrV
199299,199713,414,-1,1,chrV
191958,192624,666,-1,1,chrV
164343,164661,318,-1,1,chrV
150300,150978,678,-1,1,chrV
127803,128130,327,-1,1,chrV
127356,127740,384,-1,1,chrV
85044,85545,501,-1,1,chrV
83049,84552,1503,-1,1,chrV
79635,79977,342,-1,1,chrV
71427,71799,372,-1,1,chrV
36534,39651,3117,-1,1,chrV
29796,31239,1443,-1,1,chrV
4083,4599,516,-1,1,chrV
574886,575393,507,-1,2,chrV
574181,574517,336,-1,2,chrV
561704,562625,921,-1,2,chrV
556295,558680,2385,-1,2,chrV
538433,539168,735,-1,2,chrV
529529,536021,6492,-1,2,chrV
499346,500348,1002,-1,2,chrV
494660,495053,393,-1,2,chrV
469685,472424,2739,-1,2,chrV
457805,460223,2418,-1,2,chrV
447701,449024,1323,-1,2,chrV
437951,438344,393,-1,2,chrV
414929,415277,348,-1,2,chrV
413393,414179,786,-1,2,chrV
401501,401804,303,-1,2,chrV
378761,382103,3342,-1,2,chrV
348728,349346,618,-1,2,chrV
343319,347612,4293,-1,2,chrV
339863,342167,2304,-1,2,chrV
335945,337340,1395,-1,2,chrV
319901,320240,339,-1,2,chrV
301946,302327,381,-1,2,chrV
282704,284222,1518,-1,2,chrV
279929,280682,753,-1,2,chrV
278297,279626,1329,-1,2,chrV
253970,254579,609,-1,2,chrV
243809,246503,2694,-1,2,chrV
237569,238016,447,-1,2,chrV
235769,237119,1350,-1,2,chrV
230438,231035,597,-1,2,chrV
228455,229205,750,-1,2,chrV
167807,171818,4011,-1,2,chrV
148721,150014,1293,-1,2,chrV
138917,139763,846,-1,2,chrV
136370,136778,408,-1,2,chrV
124736,126218,1482,-1,2,chrV
121454,121988,534,-1,2,chrV
120497,121301,804,-1,2,chrV
118616,120299,1683,-1,2,chrV
116201,116678,477,-1,2,chrV
113021,113405,384,-1,2,chrV
112634,112979,345,-1,2,chrV
108503,110552,2049,-1,2,chrV
96857,97796,939,-1,2,chrV
67628,68792,1164,-1,2,chrV
65384,66797,1413,-1,2,chrV
59669,60851,1182,-1,2,chrV
53900,56102,2202,-1,2,chrV
48470,51539,3069,-1,2,chrV
21536,23231,1695,-1,2,chrV
7229,7553,324,-1,2,chrV
4463,5114,651,-1,2,chrV
263,4097,3834,-1,2,chrV
1632,1968,336,1,0,chrVI
14574,14970,396,1,0,chrVI
46737,47067,330,1,0,chrVI
74871,75192,321,1,0,chrVI
76830,77988,1158,1,0,chrVI
109809,110184,375,1,0,chrVI
110646,111093,447,1,0,chrVI
112344,113985,1641,1,0,chrVI
139476,143517,4041,1,0,chrVI
149109,149724,615,1,0,chrVI
150015,152535,2520,1,0,chrVI
156144,157752,1608,1,0,chrVI
165066,166566,1500,1,0,chrVI
178002,178413,411,1,0,chrVI
179943,180396,453,1,0,chrVI
182307,182664,357,1,0,chrVI
183021,183321,300,1,0,chrVI
194811,196314,1503,1,0,chrVI
210936,212973,2037,1,0,chrVI
217320,217644,324,1,0,chrVI
224382,224730,348,1,0,chrVI
226962,227337,375,1,0,chrVI
227517,227856,339,1,0,chrVI
240282,240597,315,1,0,chrVI
244323,244713,390,1,0,chrVI
252504,253329,825,1,0,chrVI
52,535,483,1,1,chrVI
835,1363,528,1,1,chrVI
5065,5521,456,1,1,chrVI
9544,10222,678,1,1,chrVI
11362,12259,897,1,1,chrVI
12928,13951,1023,1,1,chrVI
23422,25198,1776,1,1,chrVI
28231,29629,1398,1,1,chrVI
36802,38674,1872,1,1,chrVI
40420,42565,2145,1,1,chrVI
42814,43438,624,1,1,chrVI
43684,44053,369,1,1,chrVI
49138,51007,1869,1,1,chrVI
51349,52972,1623,1,1,chrVI
56335,57709,1374,1,1,chrVI
65476,68698,3222,1,1,chrVI
69523,70054,531,1,1,chrVI
75178,75871,693,1,1,chrVI
80764,81115,351,1,1,chrVI
82579,83875,1296,1,1,chrVI
90985,93376,2391,1,1,chrVI
95965,97498,1533,1,1,chrVI
106414,106732,318,1,1,chrVI
119428,123106,3678,1,1,chrVI
123478,129910,6432,1,1,chrVI
130333,130981,648,1,1,chrVI
131809,134296,2487,1,1,chrVI
136081,136453,372,1,1,chrVI
145726,146026,300,1,1,chrVI
147130,148459,1329,1,1,chrVI
159298,160360,1062,1,1,chrVI
160534,161200,666,1,1,chrVI
162487,164746,2259,1,1,chrVI
167887,168496,609,1,1,chrVI
169921,172285,2364,1,1,chrVI
184501,191338,6837,1,1,chrVI
192736,193435,699,1,1,chrVI
199873,201709,1836,1,1,chrVI
207451,208297,846,1,1,chrVI
234241,237250,3009,1,1,chrVI
240475,240775,300,1,1,chrVI
246145,248134,1989,1,1,chrVI
821,1280,459,1,2,chrVI
6425,7565,1140,1,2,chrVI
17003,18680,1677,1,2,chrVI
24569,24911,342,1,2,chrVI
58781,62837,4056,1,2,chrVI
107255,107585,330,1,2,chrVI
107798,108602,804,1,2,chrVI
109211,109514,303,1,2,chrVI
116144,118484,2340,1,2,chrVI
138203,139520,1317,1,2,chrVI
153392,154313,921,1,2,chrVI
168866,169310,444,1,2,chrVI
182234,182651,417,1,2,chrVI
196832,199034,2202,1,2,chrVI
209894,210194,300,1,2,chrVI
213311,216419,3108,1,2,chrVI
225050,225803,753,1,2,chrVI
227450,228101,651,1,2,chrVI
229379,231941,2562,1,2,chrVI
238457,239060,603,1,2,chrVI
242141,242999,858,1,2,chrVI
248522,248894,372,1,2,chrVI
250499,250820,321,1,2,chrVI
264203,265226,1023,1,2,chrVI
269060,269516,456,1,2,chrVI
258854,259433,579,-1,0,chrVI
249065,249866,801,-1,0,chrVI
222089,222959,870,-1,0,chrVI
216593,220106,3513,-1,0,chrVI
212210,212642,432,-1,0,chrVI
208412,210068,1656,-1,0,chrVI
201959,203081,1122,-1,0,chrVI
182273,182861,588,-1,0,chrVI
177041,180743,3702,-1,0,chrVI
166745,167258,513,-1,0,chrVI
154526,155873,1347,-1,0,chrVI
151634,151970,336,-1,0,chrVI
141395,141710,315,-1,0,chrVI
105569,105947,378,-1,0,chrVI
103982,104462,480,-1,0,chrVI
101627,103127,1500,-1,0,chrVI
99230,99599,369,-1,0,chrVI
79343,80213,870,-1,0,chrVI
45719,47744,2025,-1,0,chrVI
44654,45560,906,-1,0,chrVI
20846,22787,1941,-1,0,chrVI
14792,15431,639,-1,0,chrVI
3029,3338,309,-1,0,chrVI
1436,2615,1179,-1,0,chrVI
263956,264325,369,-1,1,chrVI
253591,255049,1458,-1,1,chrVI
250162,251803,1641,-1,1,chrVI
243073,244159,1086,-1,1,chrVI
239113,239827,714,-1,1,chrVI
237367,238255,888,-1,1,chrVI
230407,230800,393,-1,1,chrVI
227512,229186,1674,-1,1,chrVI
226120,226465,345,-1,1,chrVI
225019,225958,939,-1,1,chrVI
214753,215146,393,-1,1,chrVI
207856,208261,405,-1,1,chrVI
205747,206257,510,-1,1,chrVI
202060,202654,594,-1,1,chrVI
185197,185503,306,-1,1,chrVI
184759,185065,306,-1,1,chrVI
183130,184222,1092,-1,1,chrVI
152656,153124,468,-1,1,chrVI
107851,109930,2079,-1,1,chrVI
106468,106963,495,-1,1,chrVI
46426,46735,309,-1,1,chrVI
43627,44392,765,-1,1,chrVI
38842,40180,1338,-1,1,chrVI
33271,35848,2577,-1,1,chrVI
10300,10969,669,-1,1,chrVI
253428,253734,306,-1,2,chrVI
251049,251487,438,-1,2,chrVI
247512,248058,546,-1,2,chrVI
244278,245166,888,-1,2,chrVI
239991,241437,1446,-1,2,chrVI
232011,233544,1533,-1,2,chrVI
224325,224769,444,-1,2,chrVI
203742,204750,1008,-1,2,chrVI
187068,187419,351,-1,2,chrVI
174264,176391,2127,-1,2,chrVI
172536,173877,1341,-1,2,chrVI
170115,170652,537,-1,2,chrVI
145113,146934,1821,-1,2,chrVI
134520,137157,2637,-1,2,chrVI
132498,132852,354,-1,2,chrVI
132009,132411,402,-1,2,chrVI
115107,115743,636,-1,2,chrVI
104700,106236,1536,-1,2,chrVI
100251,100605,354,-1,2,chrVI
96642,97026,384,-1,2,chrVI
95760,96615,855,-1,2,chrVI
93498,95010,1512,-1,2,chrVI
87846,90345,2499,-1,2,chrVI
84144,87234,3090,-1,2,chrVI
80418,81912,1494,-1,2,chrVI
78054,79161,1107,-1,2,chrVI
69114,74427,5313,-1,2,chrVI
63015,63795,780,-1,2,chrVI
55365,55986,621,-1,2,chrVI
53259,54342,1083,-1,2,chrVI
52584,52995,411,-1,2,chrVI
34824,35133,309,-1,2,chrVI
30057,30540,483,-1,2,chrVI
14304,14763,459,-1,2,chrVI
3321,3846,525,-1,2,chrVI
774,1302,528,-1,2,chrVI
8469,8967,498,1,0,chrVII
11109,11730,621,1,0,chrVII
23934,25395,1461,1,0,chrVII
35652,36762,1110,1,0,chrVII
45444,48459,3015,1,0,chrVII
48513,49365,852,1,0,chrVII
49551,52434,2883,1,0,chrVII
55278,55815,537,1,0,chrVII
56481,58890,2409,1,0,chrVII
59121,61854,2733,1,0,chrVII
76893,77907,1014,1,0,chrVII
83649,84300,651,1,0,chrVII
90009,90495,486,1,0,chrVII
91431,92382,951,1,0,chrVII
92511,93591,1080,1,0,chrVII
116058,117561,1503,1,0,chrVII
129882,131169,1287,1,0,chrVII
142245,144048,1803,1,0,chrVII
144807,145197,390,1,0,chrVII
145824,146265,441,1,0,chrVII
157905,159096,1191,1,0,chrVII
168066,170571,2505,1,0,chrVII
180699,182118,1419,1,0,chrVII
199248,199587,339,1,0,chrVII
214080,215211,1131,1,0,chrVII
226398,227529,1131,1,0,chrVII
245715,248124,2409,1,0,chrVII
250497,252738,2241,1,0,chrVII
254640,255294,654,1,0,chrVII
257706,261501,3795,1,0,chrVII
261579,261915,336,1,0,chrVII
270996,272139,1143,1,0,chrVII
292032,293001,969,1,0,chrVII
312192,312840,648,1,0,chrVII
313233,314283,1050,1,0,chrVII
337905,341859,3954,1,0,chrVII
347118,349368,2250,1,0,chrVII
358635,359028,393,1,0,chrVII
396129,396495,366,1,0,chrVII
402588,403302,714,1,0,chrVII
403686,404391,705,1,0,chrVII
408888,409257,369,1,0,chrVII
418824,419289,465,1,0,chrVII
423960,425007,1047,1,0,chrVII
449787,450123,336,1,0,chrVII
452403,454560,2157,1,0,chrVII
466140,468807,2667,1,0,chrVII
472854,474276,1422,1,0,chrVII
512496,512823,327,1,0,chrVII
516942,520863,3921,1,0,chrVII
525228,526644,1416,1,0,chrVII
527631,528504,873,1,0,chrVII
529263,530919,1656,1,0,chrVII
532638,532941,303,1,0,chrVII
542202,543291,1089,1,0,chrVII
574887,575199,312,1,0,chrVII
575397,576504,1107,1,0,chrVII
593595,594705,1110,1,0,chrVII
606135,607143,1008,1,0,chrVII
610563,611493,930,1,0,chrVII
640719,641832,1113,1,0,chrVII
642009,643008,999,1,0,chrVII
644043,644595,552,1,0,chrVII
654600,656322,1722,1,0,chrVII
676620,677565,945,1,0,chrVII
685599,685911,312,1,0,chrVII
701277,701583,306,1,0,chrVII
702666,703116,450,1,0,chrVII
703635,705051,1416,1,0,chrVII
708555,712254,3699,1,0,chrVII
715827,717030,1203,1,0,chrVII
717357,718527,1170,1,0,chrVII
720408,724764,4356,1,0,chrVII
728253,728586,333,1,0,chrVII
750399,751047,648,1,0,chrVII
754725,755250,525,1,0,chrVII
759648,759960,312,1,0,chrVII
761391,762168,777,1,0,chrVII
770568,771972,1404,1,0,chrVII
786108,786438,330,1,0,chrVII
789030,790329,1299,1,0,chrVII
807072,807684,612,1,0,chrVII
811737,813054,1317,1,0,chrVII
824058,826917,2859,1,0,chrVII
828624,828960,336,1,0,chrVII
830514,832197,1683,1,0,chrVII
832455,833157,702,1,0,chrVII
837141,840558,3417,1,0,chrVII
869220,869598,378,1,0,chrVII
876981,877347,366,1,0,chrVII
880419,882231,1812,1,0,chrVII
897501,899781,2280,1,0,chrVII
910431,910737,306,1,0,chrVII
915240,916701,1461,1,0,chrVII
945144,946374,1230,1,0,chrVII
978306,978828,522,1,0,chrVII
982545,982986,441,1,0,chrVII
985971,986739,768,1,0,chrVII
1000926,1002240,1314,1,0,chrVII
1021647,1022058,411,1,0,chrVII
1022655,1024761,2106,1,0,chrVII
1031790,1037694,5904,1,0,chrVII
1046730,1048464,1734,1,0,chrVII
1052823,1057257,4434,1,0,chrVII
1070292,1071714,1422,1,0,chrVII
1076598,1078353,1755,1,0,chrVII
5311,5839,528,1,1,chrVII
20977,22108,1131,1,1,chrVII
22303,23203,900,1,1,chrVII
31897,32635,738,1,1,chrVII
33097,35212,2115,1,1,chrVII
38974,41149,2175,1,1,chrVII
41497,43174,1677,1,1,chrVII
43306,44509,1203,1,1,chrVII
67597,69331,1734,1,1,chrVII
69670,72547,2877,1,1,chrVII
73339,73711,372,1,1,chrVII
95857,97006,1149,1,1,chrVII
98968,102076,3108,1,1,chrVII
108157,110404,2247,1,1,chrVII
112885,113233,348,1,1,chrVII
131524,139543,8019,1,1,chrVII
154714,155179,465,1,1,chrVII
174544,175345,801,1,1,chrVII
182389,184084,1695,1,1,chrVII
186058,187339,1281,1,1,chrVII
191128,191806,678,1,1,chrVII
200560,202273,1713,1,1,chrVII
202720,203833,1113,1,1,chrVII
209005,210049,1044,1,1,chrVII
210415,213667,3252,1,1,chrVII
223708,224098,390,1,1,chrVII
224590,224965,375,1,1,chrVII
225571,225877,306,1,1,chrVII
229351,229660,309,1,1,chrVII
230242,232348,2106,1,1,chrVII
264856,265156,300,1,1,chrVII
288511,289309,798,1,1,chrVII
299977,301369,1392,1,1,chrVII
306559,307009,450,1,1,chrVII
309208,309751,543,1,1,chrVII
317341,318079,738,1,1,chrVII
321781,323230,1449,1,1,chrVII
325330,326161,831,1,1,chrVII
334885,337639,2754,1,1,chrVII
343318,344584,1266,1,1,chrVII
345835,346201,366,1,1,chrVII
349615,350440,825,1,1,chrVII
357376,358339,963,1,1,chrVII
359443,360100,657,1,1,chrVII
368752,371254,2502,1,1,chrVII
377608,379582,1974,1,1,chrVII
382276,382669,393,1,1,chrVII
383653,384766,1113,1,1,chrVII
385195,388732,3537,1,1,chrVII
389971,391990,2019,1,1,chrVII
393985,394504,519,1,1,chrVII
405775,406597,822,1,1,chrVII
440062,440425,363,1,1,chrVII
458155,458992,837,1,1,chrVII
459853,461365,1512,1,1,chrVII
461665,464911,3246,1,1,chrVII
483259,483637,378,1,1,chrVII
485920,489442,3522,1,1,chrVII
500131,502366,2235,1,1,chrVII
506968,507940,972,1,1,chrVII
523786,524680,894,1,1,chrVII
532984,533821,837,1,1,chrVII
536056,537379,1323,1,1,chrVII
548263,553951,5688,1,1,chrVII
570901,571216,315,1,1,chrVII
577486,579130,1644,1,1,chrVII
579475,580291,816,1,1,chrVII
589825,590911,1086,1,1,chrVII
591313,591877,564,1,1,chrVII
596692,598621,1929,1,1,chrVII
599416,601141,1725,1,1,chrVII
601660,604447,2787,1,1,chrVII
617620,617989,369,1,1,chrVII
624103,624442,339,1,1,chrVII
627082,627418,336,1,1,chrVII
627805,631273,3468,1,1,chrVII
634303,635467,1164,1,1,chrVII
646108,646486,378,1,1,chrVII
656959,659770,2811,1,1,chrVII
666340,667825,1485,1,1,chrVII
668188,669907,1719,1,1,chrVII
670387,671911,1524,1,1,chrVII
678694,682135,3441,1,1,chrVII
687898,689965,2067,1,1,chrVII
690244,693097,2853,1,1,chrVII
695416,697234,1818,1,1,chrVII
742324,745435,3111,1,1,chrVII
745834,746527,693,1,1,chrVII
746797,747736,939,1,1,chrVII
756895,757447,552,1,1,chrVII
762427,763153,726,1,1,chrVII
767428,770299,2871,1,1,chrVII
772453,773686,1233,1,1,chrVII
775192,777508,2316,1,1,chrVII
779071,779422,351,1,1,chrVII
790849,791488,639,1,1,chrVII
800545,801823,1278,1,1,chrVII
813010,817051,4041,1,1,chrVII
824131,824461,330,1,1,chrVII
827551,828577,1026,1,1,chrVII
843853,844960,1107,1,1,chrVII
848719,849067,348,1,1,chrVII
851851,852226,375,1,1,chrVII
858286,858604,318,1,1,chrVII
865189,865495,306,1,1,chrVII
873706,874033,327,1,1,chrVII
885034,885427,393,1,1,chrVII
905236,905683,447,1,1,chrVII
922174,922507,333,1,1,chrVII
936034,936376,342,1,1,chrVII
939922,940804,882,1,1,chrVII
942805,944647,1842,1,1,chrVII
947419,948997,1578,1,1,chrVII
949519,949867,348,1,1,chrVII
953959,954646,687,1,1,chrVII
963670,964186,516,1,1,chrVII
972637,973003,366,1,1,chrVII
976414,976723,309,1,1,chrVII
977335,977776,441,1,1,chrVII
979918,980476,558,1,1,chrVII
988048,989419,1371,1,1,chrVII
995638,996229,591,1,1,chrVII
996868,998188,1320,1,1,chrVII
1004623,1006102,1479,1,1,chrVII
1027369,1031509,4140,1,1,chrVII
1043188,1043749,561,1,1,chrVII
1085203,1090591,5388,1,1,chrVII
2789,3932,1143,1,2,chrVII
14909,16307,1398,1,2,chrVII
36932,37526,594,1,2,chrVII
62555,63002,447,1,2,chrVII
82373,82736,363,1,2,chrVII
84884,87302,2418,1,2,chrVII
87980,89339,1359,1,2,chrVII
93791,94460,669,1,2,chrVII
95357,95708,351,1,2,chrVII
97337,98585,1248,1,2,chrVII
114353,114659,306,1,2,chrVII
118013,118340,327,1,2,chrVII
119510,119825,315,1,2,chrVII
122954,123299,345,1,2,chrVII
123590,124298,708,1,2,chrVII
124697,129161,4464,1,2,chrVII
160064,162758,2694,1,2,chrVII
164321,164699,378,1,2,chrVII
167558,167906,348,1,2,chrVII
187463,187796,333,1,2,chrVII
188627,188930,303,1,2,chrVII
189326,189728,402,1,2,chrVII
192143,192512,369,1,2,chrVII
198137,199037,900,1,2,chrVII
207032,208571,1539,1,2,chrVII
216272,217298,1026,1,2,chrVII
217523,220922,3399,1,2,chrVII
223463,223772,309,1,2,chrVII
238352,241085,2733,1,2,chrVII
255662,256964,1302,1,2,chrVII
266144,267524,1380,1,2,chrVII
272519,274322,1803,1,2,chrVII
277616,278381,765,1,2,chrVII
284441,285947,1506,1,2,chrVII
289808,291641,1833,1,2,chrVII
293459,295637,2178,1,2,chrVII
295931,297938,2007,1,2,chrVII
303512,303836,324,1,2,chrVII
307436,308567,1131,1,2,chrVII
311576,311927,351,1,2,chrVII
314630,316553,1923,1,2,chrVII
342671,342983,312,1,2,chrVII
353057,355472,2415,1,2,chrVII
355826,356972,1146,1,2,chrVII
372011,374084,2073,1,2,chrVII
375086,375671,585,1,2,chrVII
376100,377255,1155,1,2,chrVII
392222,393698,1476,1,2,chrVII
396716,397046,330,1,2,chrVII
397937,398282,345,1,2,chrVII
398627,400160,1533,1,2,chrVII
403436,403742,306,1,2,chrVII
411551,412160,609,1,2,chrVII
414101,415730,1629,1,2,chrVII
417482,418412,930,1,2,chrVII
428600,431330,2730,1,2,chrVII
449360,449666,306,1,2,chrVII
451265,451841,576,1,2,chrVII
454784,457067,2283,1,2,chrVII
475544,476069,525,1,2,chrVII
481319,481688,369,1,2,chrVII
481811,482210,399,1,2,chrVII
494516,495167,651,1,2,chrVII
502937,504326,1389,1,2,chrVII
506069,506825,756,1,2,chrVII
511544,512732,1188,1,2,chrVII
513158,514340,1182,1,2,chrVII
514553,516416,1863,1,2,chrVII
522260,522833,573,1,2,chrVII
537857,541325,3468,1,2,chrVII
543851,544205,354,1,2,chrVII
546440,547469,1029,1,2,chrVII
560681,561350,669,1,2,chrVII
584894,586052,1158,1,2,chrVII
607562,609101,1539,1,2,chrVII
616727,617165,438,1,2,chrVII
618551,618902,351,1,2,chrVII
635711,636152,441,1,2,chrVII
643373,643679,306,1,2,chrVII
662357,666071,3714,1,2,chrVII
672185,675500,3315,1,2,chrVII
693362,694403,1041,1,2,chrVII
707609,708482,873,1,2,chrVII
713708,715046,1338,1,2,chrVII
718892,719924,1032,1,2,chrVII
733934,735143,1209,1,2,chrVII
739943,741662,1719,1,2,chrVII
757769,761138,3369,1,2,chrVII
762887,763262,375,1,2,chrVII
765725,766064,339,1,2,chrVII
780398,781379,981,1,2,chrVII
781766,783890,2124,1,2,chrVII
796091,796745,654,1,2,chrVII
798542,800066,1524,1,2,chrVII
802439,805049,2610,1,2,chrVII
829115,830153,1038,1,2,chrVII
847973,848315,342,1,2,chrVII
867773,869981,2208,1,2,chrVII
888881,889622,741,1,2,chrVII
894692,897146,2454,1,2,chrVII
897986,898325,339,1,2,chrVII
905933,908774,2841,1,2,chrVII
909212,910085,873,1,2,chrVII
911882,912812,930,1,2,chrVII
917039,918446,1407,1,2,chrVII
924695,930815,6120,1,2,chrVII
932540,935795,3255,1,2,chrVII
949364,949709,345,1,2,chrVII
951893,952307,414,1,2,chrVII
959903,961103,1200,1,2,chrVII
968087,968417,330,1,2,chrVII
984965,985685,720,1,2,chrVII
1012484,1014089,1605,1,2,chrVII
1026635,1026962,327,1,2,chrVII
1039955,1040273,318,1,2,chrVII
1062080,1062401,321,1,2,chrVII
1075481,1075925,444,1,2,chrVII
1080305,1080668,363,1,2,chrVII
1088930,1089506,576,1,2,chrVII
1081583,1082729,1146,-1,0,chrVII
1059014,1060040,1026,-1,0,chrVII
1057931,1058303,372,-1,0,chrVII
1045643,1046561,918,-1,0,chrVII
1026056,1026653,597,-1,0,chrVII
1025003,1025735,732,-1,0,chrVII
1019597,1021853,2256,-1,0,chrVII
1014320,1016750,2430,-1,0,chrVII
998357,999140,783,-1,0,chrVII
991175,993521,2346,-1,0,chrVII
982481,984272,1791,-1,0,chrVII
978035,979319,1284,-1,0,chrVII
966038,968687,2649,-1,0,chrVII
952547,953480,933,-1,0,chrVII
946400,946856,456,-1,0,chrVII
940868,942215,1347,-1,0,chrVII
913502,914738,1236,-1,0,chrVII
903473,904748,1275,-1,0,chrVII
902519,903344,825,-1,0,chrVII
899903,902270,2367,-1,0,chrVII
892496,894140,1644,-1,0,chrVII
880295,880661,366,-1,0,chrVII
876668,878192,1524,-1,0,chrVII
855263,856301,1038,-1,0,chrVII
848828,850436,1608,-1,0,chrVII
846932,848423,1491,-1,0,chrVII
833351,834482,1131,-1,0,chrVII
824525,825137,612,-1,0,chrVII
819632,819944,312,-1,0,chrVII
808628,809420,792,-1,0,chrVII
806411,807656,1245,-1,0,chrVII
805268,806021,753,-1,0,chrVII
794654,794990,336,-1,0,chrVII
786053,786920,867,-1,0,chrVII
776609,776915,306,-1,0,chrVII
755588,756452,864,-1,0,chrVII
736661,738203,1542,-1,0,chrVII
728045,729671,1626,-1,0,chrVII
725048,726479,1431,-1,0,chrVII
720371,721151,780,-1,0,chrVII
718103,718436,333,-1,0,chrVII
696179,696503,324,-1,0,chrVII
694583,695135,552,-1,0,chrVII
682565,687458,4893,-1,0,chrVII
637103,637577,474,-1,0,chrVII
636146,636875,729,-1,0,chrVII
611888,615965,4077,-1,0,chrVII
604772,605510,738,-1,0,chrVII
592085,592442,357,-1,0,chrVII
586391,589469,3078,-1,0,chrVII
582989,583892,903,-1,0,chrVII
573092,574142,1050,-1,0,chrVII
566144,567467,1323,-1,0,chrVII
534131,534458,327,-1,0,chrVII
529256,529586,330,-1,0,chrVII
527714,528053,339,-1,0,chrVII
517331,518015,684,-1,0,chrVII
504656,505859,1203,-1,0,chrVII
497420,497807,387,-1,0,chrVII
495452,496502,1050,-1,0,chrVII
492473,494174,1701,-1,0,chrVII
489707,490547,840,-1,0,chrVII
479909,482666,2757,-1,0,chrVII
476312,478652,2340,-1,0,chrVII
474488,475247,759,-1,0,chrVII
469091,472298,3207,-1,0,chrVII
448763,450059,1296,-1,0,chrVII
446411,448535,2124,-1,0,chrVII
406859,409604,2745,-1,0,chrVII
388967,389711,744,-1,0,chrVII
360287,361859,1572,-1,0,chrVII
350615,352298,1683,-1,0,chrVII
311504,311933,429,-1,0,chrVII
281633,283937,2304,-1,0,chrVII
278945,280523,1578,-1,0,chrVII
277745,278072,327,-1,0,chrVII
272849,273239,390,-1,0,chrVII
271772,272087,315,-1,0,chrVII
267722,269075,1353,-1,0,chrVII
261647,265859,4212,-1,0,chrVII
260738,261098,360,-1,0,chrVII
252896,253859,963,-1,0,chrVII
241352,245012,3660,-1,0,chrVII
234716,235958,1242,-1,0,chrVII
227753,228329,576,-1,0,chrVII
224639,224975,336,-1,0,chrVII
193706,196403,2697,-1,0,chrVII
180914,181382,468,-1,0,chrVII
175526,180113,4587,-1,0,chrVII
156542,157067,525,-1,0,chrVII
145808,147389,1581,-1,0,chrVII
122693,123305,612,-1,0,chrVII
102542,107504,4962,-1,0,chrVII
93263,93719,456,-1,0,chrVII
90053,91247,1194,-1,0,chrVII
82877,84257,1380,-1,0,chrVII
81425,82292,867,-1,0,chrVII
78014,78857,843,-1,0,chrVII
64502,66959,2457,-1,0,chrVII
63047,63620,573,-1,0,chrVII
60998,61394,396,-1,0,chrVII
53786,55796,2010,-1,0,chrVII
52730,53528,798,-1,0,chrVII
50360,50786,426,-1,0,chrVII
49430,49745,315,-1,0,chrVII
47531,48029,498,-1,0,chrVII
44651,45197,546,-1,0,chrVII
37616,38780,1164,-1,0,chrVII
27920,31061,3141,-1,0,chrVII
1089745,1090228,483,-1,1,chrVII
1088869,1089445,576,-1,1,chrVII
1086361,1086712,351,-1,1,chrVII
1079884,1080346,462,-1,1,chrVII
1073962,1075813,1851,-1,1,chrVII
1067221,1068991,1770,-1,1,chrVII
1061851,1063153,1302,-1,1,chrVII
1060657,1061590,933,-1,1,chrVII
1043818,1045480,1662,-1,1,chrVII
1039894,1043095,3201,-1,1,chrVII
1012480,1012921,441,-1,1,chrVII
1006204,1007305,1101,-1,1,chrVII
954673,958210,3537,-1,1,chrVII
949381,950899,1518,-1,1,chrVII
937123,938992,1869,-1,1,chrVII
936073,936883,810,-1,1,chrVII
918511,919465,954,-1,1,chrVII
907957,908377,420,-1,1,chrVII
889732,892186,2454,-1,1,chrVII
886072,887875,1803,-1,1,chrVII
882811,883810,999,-1,1,chrVII
869176,869962,786,-1,1,chrVII
866335,867520,1185,-1,1,chrVII
859900,865753,5853,-1,1,chrVII
858550,858904,354,-1,1,chrVII
840823,842551,1728,-1,1,chrVII
834688,835903,1215,-1,1,chrVII
821692,823015,1323,-1,1,chrVII
806680,807055,375,-1,1,chrVII
784222,784858,636,-1,1,chrVII
751393,753844,2451,-1,1,chrVII
747949,750091,2142,-1,1,chrVII
740566,740869,303,-1,1,chrVII
728791,729157,366,-1,1,chrVII
705358,706501,1143,-1,1,chrVII
697444,698368,924,-1,1,chrVII
675670,676441,771,-1,1,chrVII
651289,652981,1692,-1,1,chrVII
649597,650617,1020,-1,1,chrVII
648382,648907,525,-1,1,chrVII
647122,648142,1020,-1,1,chrVII
643147,643780,633,-1,1,chrVII
635614,635986,372,-1,1,chrVII
631480,634063,2583,-1,1,chrVII
620920,621799,879,-1,1,chrVII
618076,619858,1782,-1,1,chrVII
617515,617824,309,-1,1,chrVII
616327,617278,951,-1,1,chrVII
594985,595837,852,-1,1,chrVII
583933,584296,363,-1,1,chrVII
571969,573136,1167,-1,1,chrVII
562198,565666,3468,-1,1,chrVII
558148,558868,720,-1,1,chrVII
557071,557422,351,-1,1,chrVII
546808,547300,492,-1,1,chrVII
545680,546157,477,-1,1,chrVII
526972,527329,357,-1,1,chrVII
521089,522076,987,-1,1,chrVII
498475,499906,1431,-1,1,chrVII
490702,491956,1254,-1,1,chrVII
459109,459664,555,-1,1,chrVII
457162,457870,708,-1,1,chrVII
455479,455953,474,-1,1,chrVII
450196,452104,1908,-1,1,chrVII
443641,446143,2502,-1,1,chrVII
441280,442909,1629,-1,1,chrVII
433213,433579,366,-1,1,chrVII
428722,429064,342,-1,1,chrVII
410068,411286,1218,-1,1,chrVII
400870,401287,417,-1,1,chrVII
396034,397618,1584,-1,1,chrVII
385606,385924,318,-1,1,chrVII
379759,381271,1512,-1,1,chrVII
377977,378283,306,-1,1,chrVII
375049,375514,465,-1,1,chrVII
374458,374827,369,-1,1,chrVII
372733,373309,576,-1,1,chrVII
371002,371362,360,-1,1,chrVII
362224,363916,1692,-1,1,chrVII
346405,346708,303,-1,1,chrVII
342055,343042,987,-1,1,chrVII
331117,334465,3348,-1,1,chrVII
328873,330607,1734,-1,1,chrVII
319798,320122,324,-1,1,chrVII
298177,299728,1551,-1,1,chrVII
290017,290425,408,-1,1,chrVII
288013,288451,438,-1,1,chrVII
270391,270775,384,-1,1,chrVII
219190,219508,318,-1,1,chrVII
216691,217369,678,-1,1,chrVII
198670,198994,324,-1,1,chrVII
191977,193300,1323,-1,1,chrVII
187615,190468,2853,-1,1,chrVII
174841,175141,300,-1,1,chrVII
173284,174322,1038,-1,1,chrVII
163408,165091,1683,-1,1,chrVII
153166,154306,1140,-1,1,chrVII
151036,152776,1740,-1,1,chrVII
148228,148588,360,-1,1,chrVII
124813,125137,324,-1,1,chrVII
123571,124042,471,-1,1,chrVII
117853,120907,3054,-1,1,chrVII
112474,114664,2190,-1,1,chrVII
84838,85180,342,-1,1,chrVII
79111,80365,1254,-1,1,chrVII
25717,27484,1767,-1,1,chrVII
6289,6652,363,-1,1,chrVII
1088952,1089459,507,-1,2,chrVII
1088247,1088583,336,-1,2,chrVII
1063812,1064940,1128,-1,2,chrVII
1062003,1062492,489,-1,2,chrVII
1057782,1058724,942,-1,2,chrVII
1050909,1051725,816,-1,2,chrVII
1048797,1049958,1161,-1,2,chrVII
1038714,1039239,525,-1,2,chrVII
1037799,1038501,702,-1,2,chrVII
1017966,1019241,1275,-1,2,chrVII
1016973,1017759,786,-1,2,chrVII
1007670,1010766,3096,-1,2,chrVII
1002522,1003962,1440,-1,2,chrVII
996897,997236,339,-1,2,chrVII
988947,989247,300,-1,2,chrVII
979764,982068,2304,-1,2,chrVII
974874,976581,1707,-1,2,chrVII
970770,973734,2964,-1,2,chrVII
969186,970053,867,-1,2,chrVII
963297,965655,2358,-1,2,chrVII
961359,962061,702,-1,2,chrVII
942849,943281,432,-1,2,chrVII
922632,924462,1830,-1,2,chrVII
912912,913227,315,-1,2,chrVII
910842,911628,786,-1,2,chrVII
884508,885741,1233,-1,2,chrVII
872043,875109,3066,-1,2,chrVII
870231,871416,1185,-1,2,chrVII
860007,860310,303,-1,2,chrVII
853674,854895,1221,-1,2,chrVII
851046,853215,2169,-1,2,chrVII
845892,846405,513,-1,2,chrVII
842844,843591,747,-1,2,chrVII
817746,821214,3468,-1,2,chrVII
814929,815244,315,-1,2,chrVII
796797,797868,1071,-1,2,chrVII
794673,795492,819,-1,2,chrVII
790458,793053,2595,-1,2,chrVII
787311,787779,468,-1,2,chrVII
763761,765606,1845,-1,2,chrVII
731448,732927,1479,-1,2,chrVII
730032,730860,828,-1,2,chrVII
720264,720654,390,-1,2,chrVII
698988,699786,798,-1,2,chrVII
696144,696450,306,-1,2,chrVII
692175,692658,483,-1,2,chrVII
656979,657327,348,-1,2,chrVII
644859,646815,1956,-1,2,chrVII
639771,640371,600,-1,2,chrVII
637743,639513,1770,-1,2,chrVII
634878,635247,369,-1,2,chrVII
629019,629487,468,-1,2,chrVII
625323,627084,1761,-1,2,chrVII
622371,624786,2415,-1,2,chrVII
592905,593229,324,-1,2,chrVII
580434,581436,1002,-1,2,chrVII
569094,571398,2304,-1,2,chrVII
554247,554967,720,-1,2,chrVII
531882,532596,714,-1,2,chrVII
524364,524694,330,-1,2,chrVII
509046,511002,1956,-1,2,chrVII
488280,488619,339,-1,2,chrVII
465042,465435,393,-1,2,chrVII
437466,437934,468,-1,2,chrVII
435969,436329,360,-1,2,chrVII
431547,433062,1515,-1,2,chrVII
427296,427947,651,-1,2,chrVII
425361,426804,1443,-1,2,chrVII
419526,420555,1029,-1,2,chrVII
418287,418593,306,-1,2,chrVII
416145,417036,891,-1,2,chrVII
394965,395829,864,-1,2,chrVII
390114,390432,318,-1,2,chrVII
383682,384015,333,-1,2,chrVII
381522,383208,1686,-1,2,chrVII
369717,370272,555,-1,2,chrVII
368595,368922,327,-1,2,chrVII
366924,368088,1164,-1,2,chrVII
344790,345153,363,-1,2,chrVII
336390,336738,348,-1,2,chrVII
308712,310173,1461,-1,2,chrVII
304332,306273,1941,-1,2,chrVII
303648,304071,423,-1,2,chrVII
301536,303411,1875,-1,2,chrVII
300111,300414,303,-1,2,chrVII
280776,281157,381,-1,2,chrVII
274779,276714,1935,-1,2,chrVII
271242,271605,363,-1,2,chrVII
269292,270336,1044,-1,2,chrVII
250077,250386,309,-1,2,chrVII
248493,249531,1038,-1,2,chrVII
239553,239877,324,-1,2,chrVII
236268,238119,1851,-1,2,chrVII
232449,234507,2058,-1,2,chrVII
228750,229686,936,-1,2,chrVII
221103,225573,4470,-1,2,chrVII
215277,216096,819,-1,2,chrVII
209115,209427,312,-1,2,chrVII
199209,200142,933,-1,2,chrVII
191397,191976,579,-1,2,chrVII
184152,185394,1242,-1,2,chrVII
171414,173079,1665,-1,2,chrVII
157272,157596,324,-1,2,chrVII
154614,156012,1398,-1,2,chrVII
149703,150171,468,-1,2,chrVII
141915,142227,312,-1,2,chrVII
140367,141726,1359,-1,2,chrVII
138927,139347,420,-1,2,chrVII
137322,137733,411,-1,2,chrVII
134232,134604,372,-1,2,chrVII
133641,134037,396,-1,2,chrVII
111699,112005,306,-1,2,chrVII
80658,81186,528,-1,2,chrVII
63771,64215,444,-1,2,chrVII
40248,40677,429,-1,2,chrVII
12480,14157,1677,-1,2,chrVII
810,1293,483,1,0,chrVIII
1593,2037,444,1,0,chrVIII
2328,2664,336,1,0,chrVIII
12501,12849,348,1,0,chrVIII
15666,16119,453,1,0,chrVIII
17391,17841,450,1,0,chrVIII
40083,45690,5607,1,0,chrVIII
48762,50580,1818,1,0,chrVIII
52353,52677,324,1,0,chrVIII
58272,58605,333,1,0,chrVIII
67710,68304,594,1,0,chrVIII
68775,69147,372,1,0,chrVIII
70275,71874,1599,1,0,chrVIII
75411,75777,366,1,0,chrVIII
85908,87150,1242,1,0,chrVIII
97731,98085,354,1,0,chrVIII
117813,119439,1626,1,0,chrVIII
123105,123414,309,1,0,chrVIII
127779,129120,1341,1,0,chrVIII
134553,136533,1980,1,0,chrVIII
138693,139851,1158,1,0,chrVIII
142248,142602,354,1,0,chrVIII
151665,157452,5787,1,0,chrVIII
162516,162861,345,1,0,chrVIII
173343,175089,1746,1,0,chrVIII
178218,180111,1893,1,0,chrVIII
184065,184758,693,1,0,chrVIII
187923,189024,1101,1,0,chrVIII
190542,192618,2076,1,0,chrVIII
204606,206151,1545,1,0,chrVIII
220107,220500,393,1,0,chrVIII
225441,225777,336,1,0,chrVIII
228282,228588,306,1,0,chrVIII
237003,237693,690,1,0,chrVIII
239097,241293,2196,1,0,chrVIII
246192,248337,2145,1,0,chrVIII
251100,252225,1125,1,0,chrVIII
256359,258018,1659,1,0,chrVIII
267537,268092,555,1,0,chrVIII
274173,276240,2067,1,0,chrVIII
302760,313995,11235,1,0,chrVIII
324765,325410,645,1,0,chrVIII
328302,330060,1758,1,0,chrVIII
330309,332067,1758,1,0,chrVIII
336336,337809,1473,1,0,chrVIII
338082,339984,1902,1,0,chrVIII
341664,342120,456,1,0,chrVIII
342348,344268,1920,1,0,chrVIII
352755,353319,564,1,0,chrVIII
358857,359163,306,1,0,chrVIII
360912,361644,732,1,0,chrVIII
370053,370449,396,1,0,chrVIII
371748,372558,810,1,0,chrVIII
375708,377250,1542,1,0,chrVIII
380571,381291,720,1,0,chrVIII
385509,386487,978,1,0,chrVIII
401433,401955,522,1,0,chrVIII
423723,424473,750,1,0,chrVIII
439341,440127,786,1,0,chrVIII
440376,441933,1557,1,0,chrVIII
451326,452640,1314,1,0,chrVIII
452871,453441,570,1,0,chrVIII
462501,463704,1203,1,0,chrVIII
465177,465669,492,1,0,chrVIII
472743,474459,1716,1,0,chrVIII
486825,487662,837,1,0,chrVIII
490746,491712,966,1,0,chrVIII
541650,542262,612,1,0,chrVIII
560172,562047,1875,1,0,chrVIII
1579,1954,375,1,1,chrVIII
6400,7546,1146,1,1,chrVIII
13564,14272,708,1,1,chrVIII
23926,24295,369,1,1,chrVIII
33175,33637,462,1,1,chrVIII
39073,39535,462,1,1,chrVIII
54850,55849,999,1,1,chrVIII
70366,70666,300,1,1,chrVIII
87391,91318,3927,1,1,chrVIII
106054,107368,1314,1,1,chrVIII
108811,109885,1074,1,1,chrVIII
127003,127492,489,1,1,chrVIII
132046,132922,876,1,1,chrVIII
143995,146062,2067,1,1,chrVIII
149224,149680,456,1,1,chrVIII
160843,161485,642,1,1,chrVIII
195550,197233,1683,1,1,chrVIII
206461,207193,732,1,1,chrVIII
209704,210151,447,1,1,chrVIII
210847,211978,1131,1,1,chrVIII
217405,217840,435,1,1,chrVIII
232132,233296,1164,1,1,chrVIII
234880,236380,1500,1,1,chrVIII
242581,245572,2991,1,1,chrVIII
259612,260131,519,1,1,chrVIII
265237,265759,522,1,1,chrVIII
272626,273616,990,1,1,chrVIII
275401,275905,504,1,1,chrVIII
276763,277768,1005,1,1,chrVIII
278152,279724,1572,1,1,chrVIII
280819,281155,336,1,1,chrVIII
281494,282382,888,1,1,chrVIII
284053,284389,336,1,1,chrVIII
285400,285823,423,1,1,chrVIII
289141,289690,549,1,1,chrVIII
292942,293437,495,1,1,chrVIII
297619,298045,426,1,1,chrVIII
320413,322972,2559,1,1,chrVIII
325597,326626,1029,1,1,chrVIII
332281,332920,639,1,1,chrVIII
346042,349285,3243,1,1,chrVIII
349573,352453,2880,1,1,chrVIII
356560,358444,1884,1,1,chrVIII
373579,373924,345,1,1,chrVIII
412906,413455,549,1,1,chrVIII
442180,443476,1296,1,1,chrVIII
443827,445384,1557,1,1,chrVIII
454228,455527,1299,1,1,chrVIII
459298,461530,2232,1,1,chrVIII
467227,467914,687,1,1,chrVIII
470959,472429,1470,1,1,chrVIII
479359,479710,351,1,1,chrVIII
484027,484600,573,1,1,chrVIII
488656,490396,1740,1,1,chrVIII
496504,496819,315,1,1,chrVIII
499078,499885,807,1,1,chrVIII
502387,504196,1809,1,1,chrVIII
509362,511837,2475,1,1,chrVIII
512731,514600,1869,1,1,chrVIII
517531,518713,1182,1,1,chrVIII
519421,520312,891,1,1,chrVIII
525391,528619,3228,1,1,chrVIII
540799,541099,300,1,1,chrVIII
543007,543493,486,1,1,chrVIII
554395,555967,1572,1,1,chrVIII
558013,558637,624,1,1,chrVIII
559051,559924,873,1,1,chrVIII
560383,560959,576,1,1,chrVIII
9980,10307,327,1,2,chrVIII
14900,15413,513,1,2,chrVIII
21782,23540,1758,1,2,chrVIII
26240,27881,1641,1,2,chrVIII
35372,35798,426,1,2,chrVIII
37049,37388,339,1,2,chrVIII
47606,47933,327,1,2,chrVIII
51110,52988,1878,1,2,chrVIII
56648,58790,2142,1,2,chrVIII
69707,70070,363,1,2,chrVIII
78935,80417,1482,1,2,chrVIII
80735,81128,393,1,2,chrVIII
99218,100403,1185,1,2,chrVIII
102611,103970,1359,1,2,chrVIII
129851,130448,597,1,2,chrVIII
137156,137459,303,1,2,chrVIII
159437,160511,1074,1,2,chrVIII
167351,167672,321,1,2,chrVIII
175547,176819,1272,1,2,chrVIII
180344,181760,1416,1,2,chrVIII
181976,183704,1728,1,2,chrVIII
189254,189761,507,1,2,chrVIII
199274,199613,339,1,2,chrVIII
207653,209303,1650,1,2,chrVIII
220724,221270,546,1,2,chrVIII
229334,230696,1362,1,2,chrVIII
230969,231812,843,1,2,chrVIII
259538,259874,336,1,2,chrVIII
266213,266555,342,1,2,chrVIII
286190,286643,453,1,2,chrVIII
316571,319814,3243,1,2,chrVIII
323408,324392,984,1,2,chrVIII
333071,334394,1323,1,2,chrVIII
344453,345206,753,1,2,chrVIII
353624,354320,696,1,2,chrVIII
355040,356081,1041,1,2,chrVIII
362009,362765,756,1,2,chrVIII
383537,384488,951,1,2,chrVIII
390299,391697,1398,1,2,chrVIII
393533,394085,552,1,2,chrVIII
397250,398990,1740,1,2,chrVIII
402965,406178,3213,1,2,chrVIII
407102,410789,3687,1,2,chrVIII
417548,419063,1515,1,2,chrVIII
423071,423461,390,1,2,chrVIII
426053,426461,408,1,2,chrVIII
432899,433259,360,1,2,chrVIII
436646,436958,312,1,2,chrVIII
445712,447605,1893,1,2,chrVIII
448334,450806,2472,1,2,chrVIII
456590,457952,1362,1,2,chrVIII
468218,470576,2358,1,2,chrVIII
480989,481919,930,1,2,chrVIII
484844,486179,1335,1,2,chrVIII
491930,493658,1728,1,2,chrVIII
493895,496187,2292,1,2,chrVIII
506318,508709,2391,1,2,chrVIII
539150,539747,597,1,2,chrVIII
548666,549002,336,1,2,chrVIII
552098,553502,1404,1,2,chrVIII
559931,560249,318,1,2,chrVIII
560405,560912,507,-1,0,chrVIII
556580,557042,462,-1,0,chrVIII
545768,546161,393,-1,0,chrVIII
537758,538094,336,-1,0,chrVIII
514904,516485,1581,-1,0,chrVIII
507767,508073,306,-1,0,chrVIII
499949,501143,1194,-1,0,chrVIII
497489,498422,933,-1,0,chrVIII
474626,475340,714,-1,0,chrVIII
473204,473552,348,-1,0,chrVIII
451358,451877,519,-1,0,chrVIII
441239,441740,501,-1,0,chrVIII
413684,417179,3495,-1,0,chrVIII
411383,412406,1023,-1,0,chrVIII
394454,396659,2205,-1,0,chrVIII
378218,379199,981,-1,0,chrVIII
377354,377699,345,-1,0,chrVIII
375737,376388,651,-1,0,chrVIII
370721,371597,876,-1,0,chrVIII
368501,369794,1293,-1,0,chrVIII
365339,367892,2553,-1,0,chrVIII
364964,365300,336,-1,0,chrVIII
360947,361451,504,-1,0,chrVIII
339257,339836,579,-1,0,chrVIII
334526,335663,1137,-1,0,chrVIII
299144,301934,2790,-1,0,chrVIII
294668,296447,1779,-1,0,chrVIII
290912,292625,1713,-1,0,chrVIII
282680,283298,618,-1,0,chrVIII
248438,249641,1203,-1,0,chrVIII
227531,229163,1632,-1,0,chrVIII
225524,227243,1719,-1,0,chrVIII
218996,219884,888,-1,0,chrVIII
218225,218843,618,-1,0,chrVIII
204956,205256,300,-1,0,chrVIII
184874,186809,1935,-1,0,chrVIII
170798,172970,2172,-1,0,chrVIII
161729,164711,2982,-1,0,chrVIII
141893,143558,1665,-1,0,chrVIII
136880,138029,1149,-1,0,chrVIII
136262,136562,300,-1,0,chrVIII
122888,123590,702,-1,0,chrVIII
113498,114917,1419,-1,0,chrVIII
110027,111317,1290,-1,0,chrVIII
98342,98795,453,-1,0,chrVIII
95117,97937,2820,-1,0,chrVIII
77429,78353,924,-1,0,chrVIII
67730,69548,1818,-1,0,chrVIII
62960,64157,1197,-1,0,chrVIII
49079,49514,435,-1,0,chrVIII
45053,45458,405,-1,0,chrVIII
43718,44021,303,-1,0,chrVIII
27977,32756,4779,-1,0,chrVIII
3725,4541,816,-1,0,chrVIII
2207,3311,1104,-1,0,chrVIII
1532,1976,444,-1,0,chrVIII
547909,549346,1437,-1,1,chrVIII
520711,521737,1026,-1,1,chrVIII
512821,513127,306,-1,1,chrVIII
504475,505066,591,-1,1,chrVIII
487711,488236,525,-1,1,chrVIII
486229,486631,402,-1,1,chrVIII
473275,473647,372,-1,1,chrVIII
470938,471412,474,-1,1,chrVIII
470227,470548,321,-1,1,chrVIII
469516,469822,306,-1,1,chrVIII
450814,451153,339,-1,1,chrVIII
446284,446677,393,-1,1,chrVIII
444127,444529,402,-1,1,chrVIII
429706,436948,7242,-1,1,chrVIII
424609,429178,4569,-1,1,chrVIII
418513,418876,363,-1,1,chrVIII
416704,417136,432,-1,1,chrVIII
404515,404881,366,-1,1,chrVIII
402085,402682,597,-1,1,chrVIII
392638,393283,645,-1,1,chrVIII
387787,388726,939,-1,1,chrVIII
380107,380419,312,-1,1,chrVIII
374653,375100,447,-1,1,chrVIII
362998,364153,1155,-1,1,chrVIII
359701,360181,480,-1,1,chrVIII
344320,345628,1308,-1,1,chrVIII
340108,341359,1251,-1,1,chrVIII
326812,328036,1224,-1,1,chrVIII
318229,318544,315,-1,1,chrVIII
287080,288811,1731,-1,1,chrVIII
252373,255649,3276,-1,1,chrVIII
238909,239230,321,-1,1,chrVIII
236101,236512,411,-1,1,chrVIII
233578,234658,1080,-1,1,chrVIII
224029,225169,1140,-1,1,chrVIII
221533,222478,945,-1,1,chrVIII
215182,217834,2652,-1,1,chrVIII
213184,214249,1065,-1,1,chrVIII
198739,201310,2571,-1,1,chrVIII
189130,189595,465,-1,1,chrVIII
175558,176212,654,-1,1,chrVIII
168889,170344,1455,-1,1,chrVIII
164977,167434,2457,-1,1,chrVIII
137314,137620,306,-1,1,chrVIII
130729,131446,717,-1,1,chrVIII
124108,125680,1572,-1,1,chrVIII
102586,103075,489,-1,1,chrVIII
98827,99220,393,-1,1,chrVIII
92626,94510,1884,-1,1,chrVIII
84067,85060,993,-1,1,chrVIII
80653,81616,963,-1,1,chrVIII
76096,77314,1218,-1,1,chrVIII
66241,67456,1215,-1,1,chrVIII
59122,62563,3441,-1,1,chrVIII
54820,55915,1095,-1,1,chrVIII
53218,54166,948,-1,1,chrVIII
45928,47968,2040,-1,1,chrVIII
35254,36025,771,-1,1,chrVIII
25777,26179,402,-1,1,chrVIII
22264,22573,309,-1,1,chrVIII
19087,20971,1884,-1,1,chrVIII
8350,10213,1863,-1,1,chrVIII
561198,561681,483,-1,2,chrVIII
560322,560898,576,-1,2,chrVIII
551199,551499,300,-1,2,chrVIII
543963,547431,3468,-1,2,chrVIII
527766,528168,402,-1,2,chrVIII
511431,511800,369,-1,2,chrVIII
496314,497280,966,-1,2,chrVIII
488652,489027,375,-1,2,chrVIII
482004,483837,1833,-1,2,chrVIII
475998,480672,4674,-1,2,chrVIII
459897,460203,306,-1,2,chrVIII
449580,449886,306,-1,2,chrVIII
437169,439050,1881,-1,2,chrVIII
420372,422286,1914,-1,2,chrVIII
419220,420072,852,-1,2,chrVIII
399267,400848,1581,-1,2,chrVIII
388980,389337,357,-1,2,chrVIII
372693,374310,1617,-1,2,chrVIII
351684,352164,480,-1,2,chrVIII
314115,314673,558,-1,2,chrVIII
297384,298080,696,-1,2,chrVIII
293796,294096,300,-1,2,chrVIII
284838,286770,1932,-1,2,chrVIII
283776,284625,849,-1,2,chrVIII
268458,271548,3090,-1,2,chrVIII
262800,266838,4038,-1,2,chrVIII
258243,261591,3348,-1,2,chrVIII
235335,235785,450,-1,2,chrVIII
234873,235236,363,-1,2,chrVIII
232665,233007,342,-1,2,chrVIII
222876,223758,882,-1,2,chrVIII
197397,198285,888,-1,2,chrVIII
194067,194808,741,-1,2,chrVIII
192804,193545,741,-1,2,chrVIII
191076,191460,384,-1,2,chrVIII
176964,177999,1035,-1,2,chrVIII
167676,168561,885,-1,2,chrVIII
157743,159192,1449,-1,2,chrVIII
149574,150345,771,-1,2,chrVIII
147870,148209,339,-1,2,chrVIII
140010,141402,1392,-1,2,chrVIII
120090,121683,1593,-1,2,chrVIII
111753,113094,1341,-1,2,chrVIII
100647,101883,1236,-1,2,chrVIII
81963,83721,1758,-1,2,chrVIII
72036,74244,2208,-1,2,chrVIII
64461,65859,1398,-1,2,chrVIII
38814,39486,672,-1,2,chrVIII
36378,38508,2130,-1,2,chrVIII
33192,34077,885,-1,2,chrVIII
23616,25509,1893,-1,2,chrVIII
11922,12285,363,-1,2,chrVIII
444,2088,1644,-1,2,chrVIII
1614,2397,783,1,0,chrIX
2766,3102,336,1,0,chrIX
29031,29415,384,1,0,chrIX
29415,30048,633,1,0,chrIX
39432,40140,708,1,0,chrIX
46200,46815,615,1,0,chrIX
48090,51306,3216,1,0,chrIX
55197,56379,1182,1,0,chrIX
56544,57252,708,1,0,chrIX
83301,84885,1584,1,0,chrIX
85365,87837,2472,1,0,chrIX
93618,94800,1182,1,0,chrIX
107166,107490,324,1,0,chrIX
113805,116904,3099,1,0,chrIX
122688,125733,3045,1,0,chrIX
132243,133872,1629,1,0,chrIX
144267,144639,372,1,0,chrIX
146202,146514,312,1,0,chrIX
146835,147336,501,1,0,chrIX
150558,151188,630,1,0,chrIX
171750,173028,1278,1,0,chrIX
177372,177726,354,1,0,chrIX
180426,181977,1551,1,0,chrIX
183936,186369,2433,1,0,chrIX
206580,210132,3552,1,0,chrIX
216468,217548,1080,1,0,chrIX
228549,229026,477,1,0,chrIX
249990,251913,1923,1,0,chrIX
255051,255867,816,1,0,chrIX
258912,259770,858,1,0,chrIX
260157,260919,762,1,0,chrIX
268650,270573,1923,1,0,chrIX
277722,278139,417,1,0,chrIX
292632,295737,3105,1,0,chrIX
321453,321933,480,1,0,chrIX
322341,324105,1764,1,0,chrIX
333726,334536,810,1,0,chrIX
334881,335529,648,1,0,chrIX
344061,345183,1122,1,0,chrIX
358713,359028,315,1,0,chrIX
383565,384165,600,1,0,chrIX
397293,398385,1092,1,0,chrIX
407076,407379,303,1,0,chrIX
422634,423036,402,1,0,chrIX
11491,16141,4650,1,1,chrIX
18259,18712,453,1,1,chrIX
19846,21220,1374,1,1,chrIX
37000,38983,1983,1,1,chrIX
41824,45952,4128,1,1,chrIX
63655,63997,342,1,1,chrIX
78073,80149,2076,1,1,chrIX
95215,95551,336,1,1,chrIX
102781,105676,2895,1,1,chrIX
117991,122071,4080,1,1,chrIX
130609,131665,1056,1,1,chrIX
134416,136108,1692,1,1,chrIX
142927,144085,1158,1,1,chrIX
146863,147175,312,1,1,chrIX
151594,154846,3252,1,1,chrIX
178003,179653,1650,1,1,chrIX
193594,195070,1476,1,1,chrIX
195598,196216,618,1,1,chrIX
241942,242716,774,1,1,chrIX
242785,243097,312,1,1,chrIX
243100,243628,528,1,1,chrIX
246391,246826,435,1,1,chrIX
254542,254860,318,1,1,chrIX
261436,264892,3456,1,1,chrIX
266641,267055,414,1,1,chrIX
278425,279847,1422,1,1,chrIX
295564,295903,339,1,1,chrIX
299734,300106,372,1,1,chrIX
304708,305029,321,1,1,chrIX
311164,312460,1296,1,1,chrIX
312904,313861,957,1,1,chrIX
333010,333352,342,1,1,chrIX
339343,341428,2085,1,1,chrIX
342535,342835,300,1,1,chrIX
345691,347797,2106,1,1,chrIX
357958,358261,303,1,1,chrIX
363220,364519,1299,1,1,chrIX
364888,365335,447,1,1,chrIX
367660,368026,366,1,1,chrIX
374524,374860,336,1,1,chrIX
375430,377161,1731,1,1,chrIX
380983,381814,831,1,1,chrIX
382627,383425,798,1,1,chrIX
390481,390952,471,1,1,chrIX
391051,392809,1758,1,1,chrIX
410806,411838,1032,1,1,chrIX
422353,422704,351,1,1,chrIX
423127,423619,492,1,1,chrIX
845,1328,483,1,2,chrIX
1628,2480,852,1,2,chrIX
4637,5075,438,1,2,chrIX
19514,19844,330,1,2,chrIX
47291,47693,402,1,2,chrIX
53990,54302,312,1,2,chrIX
70229,70673,444,1,2,chrIX
72137,72548,411,1,2,chrIX
85052,85442,390,1,2,chrIX
97394,98330,936,1,2,chrIX
105008,105527,519,1,2,chrIX
126203,127097,894,1,2,chrIX
128150,129581,1431,1,2,chrIX
139751,140447,696,1,2,chrIX
155420,155765,345,1,2,chrIX
156044,157178,1134,1,2,chrIX
160886,162977,2091,1,2,chrIX
166733,167444,711,1,2,chrIX
189065,190967,1902,1,2,chrIX
205634,206507,873,1,2,chrIX
212498,214703,2205,1,2,chrIX
226601,228419,1818,1,2,chrIX
233012,233396,384,1,2,chrIX
237365,237809,444,1,2,chrIX
266042,266396,354,1,2,chrIX
271160,272777,1617,1,2,chrIX
276524,277505,981,1,2,chrIX
280799,281141,342,1,2,chrIX
285665,287429,1764,1,2,chrIX
302099,302498,399,1,2,chrIX
309398,309740,342,1,2,chrIX
315092,316133,1041,1,2,chrIX
326102,327995,1893,1,2,chrIX
349121,350003,882,1,2,chrIX
353939,355481,1542,1,2,chrIX
360884,362924,2040,1,2,chrIX
370703,372998,2295,1,2,chrIX
378485,379781,1296,1,2,chrIX
381947,382382,435,1,2,chrIX
384608,385346,738,1,2,chrIX
398732,399236,504,1,2,chrIX
399776,402689,2913,1,2,chrIX
403658,404765,1107,1,2,chrIX
408467,410375,1908,1,2,chrIX
412898,413282,384,1,2,chrIX
414266,414623,357,1,2,chrIX
416123,419465,3342,1,2,chrIX
433928,434303,375,1,2,chrIX
423808,424513,705,-1,0,chrIX
422410,422782,372,-1,0,chrIX
419614,420736,1122,-1,0,chrIX
413014,414679,1665,-1,0,chrIX
404872,405967,1095,-1,0,chrIX
402382,402706,324,-1,0,chrIX
401914,402283,369,-1,0,chrIX
379027,379468,441,-1,0,chrIX
375556,375895,339,-1,0,chrIX
362092,362587,495,-1,0,chrIX
350590,353431,2841,-1,0,chrIX
339889,340291,402,-1,0,chrIX
318199,320965,2766,-1,0,chrIX
309385,310426,1041,-1,0,chrIX
308200,308575,375,-1,0,chrIX
289225,290089,864,-1,0,chrIX
280141,282652,2511,-1,0,chrIX
275107,276292,1185,-1,0,chrIX
265114,267823,2709,-1,0,chrIX
257842,258280,438,-1,0,chrIX
243997,244462,465,-1,0,chrIX
235723,237760,2037,-1,0,chrIX
233056,235474,2418,-1,0,chrIX
221080,222490,1410,-1,0,chrIX
214990,215953,963,-1,0,chrIX
210922,212005,1083,-1,0,chrIX
200152,200461,309,-1,0,chrIX
199645,200119,474,-1,0,chrIX
191029,193195,2166,-1,0,chrIX
182116,183127,1011,-1,0,chrIX
175306,177250,1944,-1,0,chrIX
169981,171505,1524,-1,0,chrIX
161140,161473,333,-1,0,chrIX
157384,160165,2781,-1,0,chrIX
146725,147145,420,-1,0,chrIX
100780,102235,1455,-1,0,chrIX
99859,100501,642,-1,0,chrIX
89947,92788,2841,-1,0,chrIX
80509,83041,2532,-1,0,chrIX
69790,73453,3663,-1,0,chrIX
61012,62728,1716,-1,0,chrIX
57337,60694,3357,-1,0,chrIX
53980,55021,1041,-1,0,chrIX
46948,47542,594,-1,0,chrIX
36898,37252,354,-1,0,chrIX
30937,32566,1629,-1,0,chrIX
16783,18553,1770,-1,0,chrIX
1567,2419,852,-1,0,chrIX
430497,432111,1614,-1,1,chrIX
422073,422865,792,-1,1,chrIX
415029,415617,588,-1,1,chrIX
412035,412770,735,-1,1,chrIX
402840,403491,651,-1,1,chrIX
394254,394557,303,-1,1,chrIX
389571,393675,4104,-1,1,chrIX
377286,378246,960,-1,1,chrIX
376647,377046,399,-1,1,chrIX
357414,360396,2982,-1,1,chrIX
356142,356895,753,-1,1,chrIX
346029,346329,300,-1,1,chrIX
342993,343656,663,-1,1,chrIX
328206,332442,4236,-1,1,chrIX
314034,314820,786,-1,1,chrIX
308601,309171,570,-1,1,chrIX
304476,307929,3453,-1,1,chrIX
303678,304104,426,-1,1,chrIX
300828,301257,429,-1,1,chrIX
296049,300009,3960,-1,1,chrIX
291960,292317,357,-1,1,chrIX
290418,291669,1251,-1,1,chrIX
281625,281934,309,-1,1,chrIX
274071,275040,969,-1,1,chrIX
272949,273846,897,-1,1,chrIX
265098,265467,369,-1,1,chrIX
261495,261873,378,-1,1,chrIX
246549,246915,366,-1,1,chrIX
244656,245559,903,-1,1,chrIX
242760,243744,984,-1,1,chrIX
242313,242685,372,-1,1,chrIX
238098,240756,2658,-1,1,chrIX
230271,231072,801,-1,1,chrIX
222936,225597,2661,-1,1,chrIX
202275,203259,984,-1,1,chrIX
187989,188784,795,-1,1,chrIX
186516,187632,1116,-1,1,chrIX
177342,177681,339,-1,1,chrIX
167580,169641,2061,-1,1,chrIX
152028,152328,300,-1,1,chrIX
149142,149988,846,-1,1,chrIX
136653,137877,1224,-1,1,chrIX
134886,135360,474,-1,1,chrIX
121506,121821,315,-1,1,chrIX
98526,99135,609,-1,1,chrIX
95064,96375,1311,-1,1,chrIX
89229,89715,486,-1,1,chrIX
87978,88716,738,-1,1,chrIX
76353,77391,1038,-1,1,chrIX
63027,68067,5040,-1,1,chrIX
45540,45855,315,-1,1,chrIX
34086,34686,600,-1,1,chrIX
33717,34077,360,-1,1,chrIX
23118,26106,2988,-1,1,chrIX
4965,6147,1182,-1,1,chrIX
437042,437735,693,-1,2,chrIX
435272,435983,711,-1,2,chrIX
433388,433721,333,-1,2,chrIX
421025,421790,765,-1,2,chrIX
406259,407642,1383,-1,2,chrIX
397214,397949,735,-1,2,chrIX
384917,385250,333,-1,2,chrIX
383555,384119,564,-1,2,chrIX
380018,380384,366,-1,2,chrIX
373076,374306,1230,-1,2,chrIX
371480,371795,315,-1,2,chrIX
365465,369908,4443,-1,2,chrIX
334091,334475,384,-1,2,chrIX
325211,325526,315,-1,2,chrIX
322928,323237,309,-1,2,chrIX
313712,314051,339,-1,2,chrIX
287789,288908,1119,-1,2,chrIX
286067,286385,318,-1,2,chrIX
283028,284999,1971,-1,2,chrIX
252041,253925,1884,-1,2,chrIX
247901,248396,495,-1,2,chrIX
241307,241775,468,-1,2,chrIX
228659,229994,1335,-1,2,chrIX
217862,220700,2838,-1,2,chrIX
203555,204653,1098,-1,2,chrIX
200489,202043,1554,-1,2,chrIX
197930,199403,1473,-1,2,chrIX
179771,180239,468,-1,2,chrIX
174581,174887,306,-1,2,chrIX
163277,165761,2484,-1,2,chrIX
144326,148709,4383,-1,2,chrIX
140612,141569,957,-1,2,chrIX
133349,133694,345,-1,2,chrIX
117023,117644,621,-1,2,chrIX
116033,116408,375,-1,2,chrIX
114908,115253,345,-1,2,chrIX
106106,113237,7131,-1,2,chrIX
84176,84533,357,-1,2,chrIX
83207,83540,333,-1,2,chrIX
74183,75773,1590,-1,2,chrIX
59705,60011,306,-1,2,chrIX
51758,53708,1950,-1,2,chrIX
40190,41444,1254,-1,2,chrIX
25259,25796,537,-1,2,chrIX
23222,23789,567,-1,2,chrIX
8792,9155,363,-1,2,chrIX
482,4997,4515,-1,2,chrIX
828,1311,483,1,0,chrX
1611,2463,852,1,0,chrX
4620,5058,438,1,0,chrX
21972,22563,591,1,0,chrX
26886,28596,1710,1,0,chrX
36918,37734,816,1,0,chrX
38004,39969,1965,1,0,chrX
53340,54183,843,1,0,chrX
54378,56178,1800,1,0,chrX
60843,63489,2646,1,0,chrX
63804,67569,3765,1,0,chrX
78483,79107,624,1,0,chrX
80154,81915,1761,1,0,chrX
85659,87495,1836,1,0,chrX
95091,95922,831,1,0,chrX
111720,112077,357,1,0,chrX
135117,135474,357,1,0,chrX
136173,136533,360,1,0,chrX
140436,141138,702,1,0,chrX
146358,146673,315,1,0,chrX
150960,151626,666,1,0,chrX
158187,159417,1230,1,0,chrX
161913,164166,2253,1,0,chrX
166464,166935,471,1,0,chrX
184500,185424,924,1,0,chrX
188370,188724,354,1,0,chrX
199398,203325,3927,1,0,chrX
207876,209529,1653,1,0,chrX
219630,219948,318,1,0,chrX
225054,226737,1683,1,0,chrX
231300,233760,2460,1,0,chrX
246300,246975,675,1,0,chrX
247254,251691,4437,1,0,chrX
272826,274698,1872,1,0,chrX
281184,283380,2196,1,0,chrX
303039,305118,2079,1,0,chrX
313506,313812,306,1,0,chrX
315174,315570,396,1,0,chrX
317283,319776,2493,1,0,chrX
323385,324720,1335,1,0,chrX
324963,326190,1227,1,0,chrX
339786,342255,2469,1,0,chrX
345972,347325,1353,1,0,chrX
360129,360903,774,1,0,chrX
361248,365445,4197,1,0,chrX
367953,368373,420,1,0,chrX
392403,393603,1200,1,0,chrX
393966,395511,1545,1,0,chrX
407424,407733,309,1,0,chrX
438864,440646,1782,1,0,chrX
462720,464253,1533,1,0,chrX
466785,467148,363,1,0,chrX
468000,468333,333,1,0,chrX
480144,483612,3468,1,0,chrX
495105,495441,336,1,0,chrX
528696,529404,708,1,0,chrX
529860,531366,1506,1,0,chrX
536055,537549,1494,1,0,chrX
567642,568704,1062,1,0,chrX
578859,580221,1362,1,0,chrX
598734,603078,4344,1,0,chrX
623580,624603,1023,1,0,chrX
624837,627015,2178,1,0,chrX
627294,628326,1032,1,0,chrX
637029,637635,606,1,0,chrX
638319,638631,312,1,0,chrX
638658,639051,393,1,0,chrX
640824,641664,840,1,0,chrX
642006,643368,1362,1,0,chrX
651900,652578,678,1,0,chrX
659106,659511,405,1,0,chrX
661620,661935,315,1,0,chrX
672990,673620,630,1,0,chrX
697140,698169,1029,1,0,chrX
700881,701691,810,1,0,chrX
703884,704238,354,1,0,chrX
722814,723900,1086,1,0,chrX
727404,728271,867,1,0,chrX
1597,2380,783,1,1,chrX
2749,3085,336,1,1,chrX
25573,25948,375,1,1,chrX
42769,43246,477,1,1,chrX
43288,43609,321,1,1,chrX
69337,70879,1542,1,1,chrX
71365,72574,1209,1,1,chrX
84067,85336,1269,1,1,chrX
88786,89116,330,1,1,chrX
94048,94561,513,1,1,chrX
105013,106072,1059,1,1,chrX
107551,107860,309,1,1,chrX
117244,117787,543,1,1,chrX
120448,121690,1242,1,1,chrX
137122,137425,303,1,1,chrX
145159,146044,885,1,1,chrX
147100,147577,477,1,1,chrX
157876,158194,318,1,1,chrX
160618,161563,945,1,1,chrX
173113,173413,300,1,1,chrX
175528,175924,396,1,1,chrX
189715,190243,528,1,1,chrX
191638,192298,660,1,1,chrX
197914,198595,681,1,1,chrX
221389,223327,1938,1,1,chrX
227326,227776,450,1,1,chrX
237262,239086,1824,1,1,chrX
239413,241654,2241,1,1,chrX
245590,246244,654,1,1,chrX
257422,260947,3525,1,1,chrX
268492,269815,1323,1,1,chrX
314083,314434,351,1,1,chrX
332743,333076,333,1,1,chrX
334264,335701,1437,1,1,chrX
356023,357928,1905,1,1,chrX
366676,367756,1080,1,1,chrX
383836,386149,2313,1,1,chrX
386347,386662,315,1,1,chrX
407557,409162,1605,1,1,chrX
419854,420181,327,1,1,chrX
432643,433000,357,1,1,chrX
436801,438610,1809,1,1,chrX
456238,457774,1536,1,1,chrX
460381,461593,1212,1,1,chrX
469726,470113,387,1,1,chrX
472759,474082,1323,1,1,chrX
491080,492262,1182,1,1,chrX
503101,503485,384,1,1,chrX
503935,507301,3366,1,1,chrX
507745,510085,2340,1,1,chrX
514054,516289,2235,1,1,chrX
538771,539266,495,1,1,chrX
548758,549814,1056,1,1,chrX
550510,553318,2808,1,1,chrX
555913,557602,1689,1,1,chrX
573094,573751,657,1,1,chrX
583732,585004,1272,1,1,chrX
586399,586750,351,1,1,chrX
609772,610741,969,1,1,chrX
611194,612043,849,1,1,chrX
612412,612931,519,1,1,chrX
616957,617308,351,1,1,chrX
628711,629083,372,1,1,chrX
647125,647476,351,1,1,chrX
662920,663280,360,1,1,chrX
695905,696949,1044,1,1,chrX
704812,705115,303,1,1,chrX
709183,709552,369,1,1,chrX
712516,713242,726,1,1,chrX
713293,714016,723,1,1,chrX
719665,721297,1632,1,1,chrX
732439,734143,1704,1,1,chrX
11474,16124,4650,1,2,chrX
18242,18695,453,1,2,chrX
19496,21200,1704,1,2,chrX
23132,23729,597,1,2,chrX
32162,33158,996,1,2,chrX
83447,83819,372,1,2,chrX
90785,91109,324,1,2,chrX
97736,99467,1731,1,2,chrX
102098,102467,369,1,2,chrX
102977,103280,303,1,2,chrX
124160,124478,318,1,2,chrX
137378,139370,1992,1,2,chrX
141422,141743,321,1,2,chrX
143291,144701,1410,1,2,chrX
191021,191345,324,1,2,chrX
192530,193466,936,1,2,chrX
196286,197126,840,1,2,chrX
198677,199157,480,1,2,chrX
205304,207449,2145,1,2,chrX
214025,214391,366,1,2,chrX
242081,245258,3177,1,2,chrX
259874,260204,330,1,2,chrX
264050,264368,318,1,2,chrX
265925,268415,2490,1,2,chrX
271769,272162,393,1,2,chrX
278840,280655,1815,1,2,chrX
295244,298814,3570,1,2,chrX
306131,307856,1725,1,2,chrX
320015,322157,2142,1,2,chrX
333356,334094,738,1,2,chrX
335897,337037,1140,1,2,chrX
338270,339269,999,1,2,chrX
342521,345743,3222,1,2,chrX
352259,353615,1356,1,2,chrX
376661,377336,675,1,2,chrX
378824,380096,1272,1,2,chrX
381326,383375,2049,1,2,chrX
387656,388247,591,1,2,chrX
391310,391646,336,1,2,chrX
398108,398417,309,1,2,chrX
402896,404945,2049,1,2,chrX
405587,407273,1686,1,2,chrX
425156,431237,6081,1,2,chrX
435344,435926,582,1,2,chrX
445922,448025,2103,1,2,chrX
449201,450665,1464,1,2,chrX
451019,451934,915,1,2,chrX
452429,453446,1017,1,2,chrX
461828,462425,597,1,2,chrX
474560,478028,3468,1,2,chrX
478343,479666,1323,1,2,chrX
496682,497009,327,1,2,chrX
497354,500612,3258,1,2,chrX
522047,523862,1815,1,2,chrX
526334,526664,330,1,2,chrX
532061,533759,1698,1,2,chrX
534026,535751,1725,1,2,chrX
544061,544712,651,1,2,chrX
545786,548243,2457,1,2,chrX
555194,555572,378,1,2,chrX
559415,566828,7413,1,2,chrX
569972,570284,312,1,2,chrX
570404,570773,369,1,2,chrX
573980,575171,1191,1,2,chrX
586067,586400,333,1,2,chrX
587717,590582,2865,1,2,chrX
615575,616286,711,1,2,chrX
618233,619034,801,1,2,chrX
620753,622490,1737,1,2,chrX
630260,630581,321,1,2,chrX
633614,635681,2067,1,2,chrX
639941,640451,510,1,2,chrX
647606,649142,1536,1,2,chrX
649775,651269,1494,1,2,chrX
667643,669293,1650,1,2,chrX
669521,672668,3147,1,2,chrX
684566,689321,4755,1,2,chrX
704195,705272,1077,1,2,chrX
705743,706874,1131,1,2,chrX
707159,708374,1215,1,2,chrX
725783,726824,1041,1,2,chrX
730514,730877,363,1,2,chrX
736043,737117,1074,1,2,chrX
742847,743999,1152,-1,0,chrX
728573,729596,1023,-1,0,chrX
714173,715397,1224,-1,0,chrX
713516,713876,360,-1,0,chrX
708998,709367,369,-1,0,chrX
702026,702872,846,-1,0,chrX
690749,695696,4947,-1,0,chrX
689444,690524,1080,-1,0,chrX
678956,683285,4329,-1,0,chrX
676058,676778,720,-1,0,chrX
658916,663059,4143,-1,0,chrX
644303,646490,2187,-1,0,chrX
638231,638975,744,-1,0,chrX
604568,605651,1083,-1,0,chrX
601358,601778,420,-1,0,chrX
599327,599633,306,-1,0,chrX
585119,585437,318,-1,0,chrX
568805,569399,594,-1,0,chrX
553475,554849,1374,-1,0,chrX
526883,528476,1593,-1,0,chrX
518762,519185,423,-1,0,chrX
492377,496451,4074,-1,0,chrX
471137,471671,534,-1,0,chrX
468554,469112,558,-1,0,chrX
467231,468281,1050,-1,0,chrX
466520,467093,573,-1,0,chrX
464450,466208,1758,-1,0,chrX
460973,461345,372,-1,0,chrX
459794,460418,624,-1,0,chrX
443999,444323,324,-1,0,chrX
440993,442613,1620,-1,0,chrX
433220,434651,1431,-1,0,chrX
431588,432200,612,-1,0,chrX
423137,424109,972,-1,0,chrX
414284,414770,486,-1,0,chrX
411233,413399,2166,-1,0,chrX
398936,402410,3474,-1,0,chrX
391832,392249,417,-1,0,chrX
368747,373799,5052,-1,0,chrX
366530,367607,1077,-1,0,chrX
315758,316475,717,-1,0,chrX
315053,315557,504,-1,0,chrX
307970,310637,2667,-1,0,chrX
299156,302849,3693,-1,0,chrX
294665,295061,396,-1,0,chrX
291335,293981,2646,-1,0,chrX
289874,290774,900,-1,0,chrX
285557,289226,3669,-1,0,chrX
272477,272846,369,-1,0,chrX
247925,248315,390,-1,0,chrX
231581,231893,312,-1,0,chrX
226271,226667,396,-1,0,chrX
218852,220016,1164,-1,0,chrX
209921,211577,1656,-1,0,chrX
193859,194873,1014,-1,0,chrX
190373,191090,717,-1,0,chrX
188003,189440,1437,-1,0,chrX
182297,184220,1923,-1,0,chrX
175502,175805,303,-1,0,chrX
175127,175502,375,-1,0,chrX
165722,172367,6645,-1,0,chrX
163730,164066,336,-1,0,chrX
153503,154691,1188,-1,0,chrX
151712,152999,1287,-1,0,chrX
151079,151394,315,-1,0,chrX
149732,150032,300,-1,0,chrX
147818,148211,393,-1,0,chrX
129284,130643,1359,-1,0,chrX
122264,122948,684,-1,0,chrX
111665,113333,1668,-1,0,chrX
107816,108122,306,-1,0,chrX
82094,82976,882,-1,0,chrX
76802,79262,2460,-1,0,chrX
74909,75302,393,-1,0,chrX
66233,66689,456,-1,0,chrX
62927,63335,408,-1,0,chrX
62153,62564,411,-1,0,chrX
59855,60182,327,-1,0,chrX
53942,54290,348,-1,0,chrX
40193,41183,990,-1,0,chrX
31817,32117,300,-1,0,chrX
26411,26771,360,-1,0,chrX
16766,18536,1770,-1,0,chrX
1550,2402,852,-1,0,chrX
744910,745261,351,-1,1,chrX
738007,739816,1809,-1,1,chrX
686683,687025,342,-1,1,chrX
677440,678706,1266,-1,1,chrX
671086,671431,345,-1,1,chrX
654736,655963,1227,-1,1,chrX
652891,654238,1347,-1,1,chrX
645523,645853,330,-1,1,chrX
643489,644101,612,-1,1,chrX
635854,636706,852,-1,1,chrX
629584,632941,3357,-1,1,chrX
622549,623014,465,-1,1,chrX
621805,622177,372,-1,1,chrX
619156,619765,609,-1,1,chrX
595060,598336,3276,-1,1,chrX
588649,589186,537,-1,1,chrX
582607,583537,930,-1,1,chrX
575353,576601,1248,-1,1,chrX
572314,572935,621,-1,1,chrX
569620,570598,978,-1,1,chrX
522937,523459,522,-1,1,chrX
519637,521602,1965,-1,1,chrX
516460,517513,1053,-1,1,chrX
510238,513763,3525,-1,1,chrX
483958,486196,2238,-1,1,chrX
469183,469579,396,-1,1,chrX
453682,454681,999,-1,1,chrX
419956,421663,1707,-1,1,chrX
409492,411040,1548,-1,1,chrX
397354,398398,1044,-1,1,chrX
388384,390853,2469,-1,1,chrX
380248,381001,753,-1,1,chrX
376798,377314,516,-1,1,chrX
349579,352108,2529,-1,1,chrX
347446,348637,1191,-1,1,chrX
344875,345220,345,-1,1,chrX
330430,333073,2643,-1,1,chrX
328117,330121,2004,-1,1,chrX
314113,314872,759,-1,1,chrX
313015,313915,900,-1,1,chrX
310921,312706,1785,-1,1,chrX
298459,298876,417,-1,1,chrX
298057,298405,348,-1,1,chrX
283801,285271,1470,-1,1,chrX
274861,278002,3141,-1,1,chrX
270001,272485,2484,-1,1,chrX
262756,265051,2295,-1,1,chrX
261079,262576,1497,-1,1,chrX
234319,236356,2037,-1,1,chrX
229024,230881,1857,-1,1,chrX
211999,217309,5310,-1,1,chrX
185527,186679,1152,-1,1,chrX
178096,180103,2007,-1,1,chrX
169150,169462,312,-1,1,chrX
166123,166429,306,-1,1,chrX
154984,156127,1143,-1,1,chrX
141418,142567,1149,-1,1,chrX
123835,126328,2493,-1,1,chrX
117961,118825,864,-1,1,chrX
102226,104428,2202,-1,1,chrX
101149,101794,645,-1,1,chrX
99703,100894,1191,-1,1,chrX
96160,96529,369,-1,1,chrX
89281,90097,816,-1,1,chrX
76201,76510,309,-1,1,chrX
72709,73414,705,-1,1,chrX
67849,68782,933,-1,1,chrX
56443,58813,2370,-1,1,chrX
24340,26086,1746,-1,1,chrX
4948,6130,1182,-1,1,chrX
712254,715740,3486,-1,2,chrX
708810,709707,897,-1,2,chrX
698325,700614,2289,-1,2,chrX
673728,675852,2124,-1,2,chrX
665217,667137,1920,-1,2,chrX
663999,665019,1020,-1,2,chrX
656253,658689,2436,-1,2,chrX
616350,617334,984,-1,2,chrX
613185,615156,1971,-1,2,chrX
603219,604203,984,-1,2,chrX
590871,594327,3456,-1,2,chrX
586494,587373,879,-1,2,chrX
581913,582255,342,-1,2,chrX
580431,581616,1185,-1,2,chrX
577254,578190,936,-1,2,chrX
570966,572124,1158,-1,2,chrX
567018,567444,426,-1,2,chrX
557808,559158,1350,-1,2,chrX
552543,552858,315,-1,2,chrX
549114,549558,444,-1,2,chrX
544731,545175,444,-1,2,chrX
541791,542502,711,-1,2,chrX
524907,525381,474,-1,2,chrX
508068,508380,312,-1,2,chrX
503709,504072,363,-1,2,chrX
500712,503391,2679,-1,2,chrX
486585,490812,4227,-1,2,chrX
470229,470964,735,-1,2,chrX
469803,470205,402,-1,2,chrX
458640,459426,786,-1,2,chrX
442908,444861,1953,-1,2,chrX
422697,423012,315,-1,2,chrX
417561,419562,2001,-1,2,chrX
386367,387240,873,-1,2,chrX
375114,375774,660,-1,2,chrX
358299,359676,1377,-1,2,chrX
326241,327873,1632,-1,2,chrX
305220,305862,642,-1,2,chrX
269100,269559,459,-1,2,chrX
254736,256812,2076,-1,2,chrX
251820,254442,2622,-1,2,chrX
237600,237954,354,-1,2,chrX
217704,218856,1152,-1,2,chrX
191571,191895,324,-1,2,chrX
187125,187644,519,-1,2,chrX
173598,177306,3708,-1,2,chrX
164277,165348,1071,-1,2,chrX
147966,150390,2424,-1,2,chrX
136371,136773,402,-1,2,chrX
134331,135999,1668,-1,2,chrX
131100,133935,2835,-1,2,chrX
126852,128952,2100,-1,2,chrX
113877,115629,1752,-1,2,chrX
111876,112185,309,-1,2,chrX
109965,111159,1194,-1,2,chrX
106893,109461,2568,-1,2,chrX
92052,94530,2478,-1,2,chrX
87582,88560,978,-1,2,chrX
85434,85752,318,-1,2,chrX
81252,81711,459,-1,2,chrX
69240,69942,702,-1,2,chrX
50628,53151,2523,-1,2,chrX
47658,49935,2277,-1,2,chrX
41388,47433,6045,-1,2,chrX
36756,37200,444,-1,2,chrX
33849,36249,2400,-1,2,chrX
25452,25752,300,-1,2,chrX
8775,9138,363,-1,2,chrX
465,4980,4515,-1,2,chrX
450,798,348,1,0,chrXI
2388,2721,333,1,0,chrXI
14484,15708,1224,1,0,chrXI
22233,24084,1851,1,0,chrXI
34542,36414,1872,1,0,chrXI
39162,42237,3075,1,0,chrXI
43641,44025,384,1,0,chrXI
53703,55602,1899,1,0,chrXI
83112,83550,438,1,0,chrXI
89481,89787,306,1,0,chrXI
96756,98157,1401,1,0,chrXI
104358,104715,357,1,0,chrXI
155646,158232,2586,1,0,chrXI
163599,164109,510,1,0,chrXI
196743,197076,333,1,0,chrXI
220323,220974,651,1,0,chrXI
226569,228765,2196,1,0,chrXI
240648,240951,303,1,0,chrXI
248919,253476,4557,1,0,chrXI
267678,267981,303,1,0,chrXI
273393,275043,1650,1,0,chrXI
278280,278664,384,1,0,chrXI
280920,281535,615,1,0,chrXI
286602,288573,1971,1,0,chrXI
306210,306720,510,1,0,chrXI
307284,307827,543,1,0,chrXI
314811,315273,462,1,0,chrXI
317763,320673,2910,1,0,chrXI
325770,326112,342,1,0,chrXI
330165,330534,369,1,0,chrXI
343479,343938,459,1,0,chrXI
365604,369117,3513,1,0,chrXI
382071,382485,414,1,0,chrXI
382497,383103,606,1,0,chrXI
386397,386706,309,1,0,chrXI
387561,388905,1344,1,0,chrXI
391869,392217,348,1,0,chrXI
393720,394554,834,1,0,chrXI
400920,401256,336,1,0,chrXI
402567,403518,951,1,0,chrXI
408543,411483,2940,1,0,chrXI
435579,436785,1206,1,0,chrXI
438825,439350,525,1,0,chrXI
445380,446727,1347,1,0,chrXI
448782,449172,390,1,0,chrXI
469716,471339,1623,1,0,chrXI
494256,497358,3102,1,0,chrXI
525900,526302,402,1,0,chrXI
527814,530484,2670,1,0,chrXI
537939,538296,357,1,0,chrXI
544212,544527,315,1,0,chrXI
547425,547788,363,1,0,chrXI
549447,551367,1920,1,0,chrXI
557676,558954,1278,1,0,chrXI
559665,560652,987,1,0,chrXI
571611,573393,1782,1,0,chrXI
573573,574632,1059,1,0,chrXI
582282,583395,1113,1,0,chrXI
590394,591357,963,1,0,chrXI
592824,596298,3474,1,0,chrXI
599856,603072,3216,1,0,chrXI
615729,617535,1806,1,0,chrXI
635850,638286,2436,1,0,chrXI
640467,642504,2037,1,0,chrXI
653079,656736,3657,1,0,chrXI
656835,657756,921,1,0,chrXI
6106,7528,1422,1,1,chrXI
48106,48955,849,1,1,chrXI
50050,53353,3303,1,1,chrXI
63820,64402,582,1,1,chrXI
75748,77032,1284,1,1,chrXI
81034,82639,1605,1,1,chrXI
84703,85903,1200,1,1,chrXI
94498,96265,1767,1,1,chrXI
114355,114694,339,1,1,chrXI
118792,120304,1512,1,1,chrXI
125758,127042,1284,1,1,chrXI
127474,130261,2787,1,1,chrXI
130633,131050,417,1,1,chrXI
144400,145378,978,1,1,chrXI
153268,153706,438,1,1,chrXI
154990,155293,303,1,1,chrXI
158617,159007,390,1,1,chrXI
166543,167452,909,1,1,chrXI
169534,169936,402,1,1,chrXI
180778,182425,1647,1,1,chrXI
185956,186292,336,1,1,chrXI
186415,186814,399,1,1,chrXI
188071,188377,306,1,1,chrXI
208246,210130,1884,1,1,chrXI
210592,212332,1740,1,1,chrXI
214141,216700,2559,1,1,chrXI
236140,237070,930,1,1,chrXI
237535,238891,1356,1,1,chrXI
262276,263113,837,1,1,chrXI
283528,284455,927,1,1,chrXI
288844,291052,2208,1,1,chrXI
299581,301882,2301,1,1,chrXI
305113,305884,771,1,1,chrXI
310198,313078,2880,1,1,chrXI
315280,315724,444,1,1,chrXI
319435,319759,324,1,1,chrXI
323227,325120,1893,1,1,chrXI
339571,339946,375,1,1,chrXI
341311,342373,1062,1,1,chrXI
349462,351013,1551,1,1,chrXI
358474,359566,1092,1,1,chrXI
360142,360817,675,1,1,chrXI
369364,369721,357,1,1,chrXI
404101,405091,990,1,1,chrXI
408898,409201,303,1,1,chrXI
416173,416560,387,1,1,chrXI
418309,420061,1752,1,1,chrXI
426241,426952,711,1,1,chrXI
429301,430108,807,1,1,chrXI
438088,438544,456,1,1,chrXI
452200,454078,1878,1,1,chrXI
479233,481981,2748,1,1,chrXI
483418,485011,1593,1,1,chrXI
496651,497221,570,1,1,chrXI
497233,497554,321,1,1,chrXI
498424,498727,303,1,1,chrXI
500281,501103,822,1,1,chrXI
505813,506125,312,1,1,chrXI
509836,510208,372,1,1,chrXI
515062,516871,1809,1,1,chrXI
518197,518950,753,1,1,chrXI
519271,520624,1353,1,1,chrXI
525256,525562,306,1,1,chrXI
534292,534664,372,1,1,chrXI
548215,549091,876,1,1,chrXI
552763,554620,1857,1,1,chrXI
554986,556174,1188,1,1,chrXI
562546,565138,2592,1,1,chrXI
579208,579676,468,1,1,chrXI
597088,597391,303,1,1,chrXI
611524,612265,741,1,1,chrXI
619804,625432,5628,1,1,chrXI
639493,639826,333,1,1,chrXI
661441,663289,1848,1,1,chrXI
25214,26159,945,1,2,chrXI
47156,47972,816,1,2,chrXI
68615,69011,396,1,2,chrXI
98720,99641,921,1,2,chrXI
100670,106826,6156,1,2,chrXI
107315,108599,1284,1,2,chrXI
109268,109613,345,1,2,chrXI
122516,125543,3027,1,2,chrXI
161600,162335,735,1,2,chrXI
171782,173861,2079,1,2,chrXI
174212,175616,1404,1,2,chrXI
176780,178172,1392,1,2,chrXI
178514,179174,660,1,2,chrXI
179666,180263,597,1,2,chrXI
182957,184544,1587,1,2,chrXI
194477,194999,522,1,2,chrXI
196817,197171,354,1,2,chrXI
203540,205253,1713,1,2,chrXI
205706,207749,2043,1,2,chrXI
212042,212423,381,1,2,chrXI
217343,218318,975,1,2,chrXI
219125,219437,312,1,2,chrXI
232226,233891,1665,1,2,chrXI
234425,235787,1362,1,2,chrXI
256769,257843,1074,1,2,chrXI
261131,261851,720,1,2,chrXI
263348,264290,942,1,2,chrXI
264788,265808,1020,1,2,chrXI
271877,273209,1332,1,2,chrXI
275282,276998,1716,1,2,chrXI
279122,280127,1005,1,2,chrXI
280508,280859,351,1,2,chrXI
285029,286208,1179,1,2,chrXI
291452,292631,1179,1,2,chrXI
296429,299075,2646,1,2,chrXI
328175,328643,468,1,2,chrXI
353492,355079,1587,1,2,chrXI
356321,356642,321,1,2,chrXI
356747,357848,1101,1,2,chrXI
362621,364193,1572,1,2,chrXI
369890,371390,1500,1,2,chrXI
371828,374105,2277,1,2,chrXI
374504,375215,711,1,2,chrXI
375455,378572,3117,1,2,chrXI
385757,387206,1449,1,2,chrXI
420443,420893,450,1,2,chrXI
421898,422336,438,1,2,chrXI
443231,444938,1707,1,2,chrXI
451433,451988,555,1,2,chrXI
463958,464948,990,1,2,chrXI
478337,478832,495,1,2,chrXI
487769,488618,849,1,2,chrXI
491363,493661,2298,1,2,chrXI
505508,505814,306,1,2,chrXI
506516,506831,315,1,2,chrXI
506897,507707,810,1,2,chrXI
507938,508553,615,1,2,chrXI
520352,520652,300,1,2,chrXI
522014,523346,1332,1,2,chrXI
523571,523955,384,1,2,chrXI
530945,532202,1257,1,2,chrXI
556517,557342,825,1,2,chrXI
561062,561374,312,1,2,chrXI
567917,570149,2232,1,2,chrXI
576440,576797,357,1,2,chrXI
583652,584744,1092,1,2,chrXI
584951,586709,1758,1,2,chrXI
608945,611066,2121,1,2,chrXI
612926,613301,375,1,2,chrXI
626792,630380,3588,1,2,chrXI
631151,632801,1650,1,2,chrXI
646355,649865,3510,1,2,chrXI
662148,662523,375,-1,0,chrXI
612930,613515,585,-1,0,chrXI
604404,605418,1014,-1,0,chrXI
597054,598890,1836,-1,0,chrXI
586788,589305,2517,-1,0,chrXI
570327,570909,582,-1,0,chrXI
566112,567198,1086,-1,0,chrXI
534066,535281,1215,-1,0,chrXI
520896,521712,816,-1,0,chrXI
519642,519951,309,-1,0,chrXI
515145,515463,318,-1,0,chrXI
511998,513264,1266,-1,0,chrXI
510909,511797,888,-1,0,chrXI
508701,510681,1980,-1,0,chrXI
497577,499833,2256,-1,0,chrXI
471693,473349,1656,-1,0,chrXI
465366,466071,705,-1,0,chrXI
461634,462696,1062,-1,0,chrXI
455145,455496,351,-1,0,chrXI
440607,442722,2115,-1,0,chrXI
433092,434877,1785,-1,0,chrXI
425487,425790,303,-1,0,chrXI
417507,418023,516,-1,0,chrXI
411618,416913,5295,-1,0,chrXI
405189,407241,2052,-1,0,chrXI
394725,397248,2523,-1,0,chrXI
389379,389883,504,-1,0,chrXI
380064,381858,1794,-1,0,chrXI
358584,358905,321,-1,0,chrXI
346074,346764,690,-1,0,chrXI
330855,333969,3114,-1,0,chrXI
328785,329169,384,-1,0,chrXI
310416,310761,345,-1,0,chrXI
294609,296193,1584,-1,0,chrXI
277188,277863,675,-1,0,chrXI
274221,274737,516,-1,0,chrXI
248061,248367,306,-1,0,chrXI
243219,245373,2154,-1,0,chrXI
239184,242583,3399,-1,0,chrXI
226833,227250,417,-1,0,chrXI
221343,222900,1557,-1,0,chrXI
206985,207297,312,-1,0,chrXI
200883,201771,888,-1,0,chrXI
189123,191442,2319,-1,0,chrXI
186459,188640,2181,-1,0,chrXI
175842,176481,639,-1,0,chrXI
169206,171129,1923,-1,0,chrXI
164916,165930,1014,-1,0,chrXI
163641,164385,744,-1,0,chrXI
149385,150687,1302,-1,0,chrXI
137931,140691,2760,-1,0,chrXI
134508,135705,1197,-1,0,chrXI
123900,124227,327,-1,0,chrXI
113214,114627,1413,-1,0,chrXI
110463,112503,2040,-1,0,chrXI
89283,91536,2253,-1,0,chrXI
74931,75534,603,-1,0,chrXI
49005,49809,804,-1,0,chrXI
48171,48573,402,-1,0,chrXI
31959,34107,2148,-1,0,chrXI
26826,30687,3861,-1,0,chrXI
17358,18339,981,-1,0,chrXI
9090,11226,2136,-1,0,chrXI
1809,2181,372,-1,0,chrXI
658715,660464,1749,-1,1,chrXI
653606,653987,381,-1,1,chrXI
638900,639968,1068,-1,1,chrXI
603194,604232,1038,-1,1,chrXI
601844,602288,444,-1,1,chrXI
599093,599681,588,-1,1,chrXI
596420,596822,402,-1,1,chrXI
578186,578507,321,-1,1,chrXI
576434,578123,1689,-1,1,chrXI
572975,573335,360,-1,1,chrXI
572399,572741,342,-1,1,chrXI
571682,572183,501,-1,1,chrXI
565298,565892,594,-1,1,chrXI
535646,547925,12279,-1,1,chrXI
528185,528557,372,-1,1,chrXI
526829,527231,402,-1,1,chrXI
525386,526640,1254,-1,1,chrXI
524222,525074,852,-1,1,chrXI
450422,451250,828,-1,1,chrXI
448520,449864,1344,-1,1,chrXI
446798,447677,879,-1,1,chrXI
438776,439385,609,-1,1,chrXI
437096,437492,396,-1,1,chrXI
408662,408962,300,-1,1,chrXI
398831,402080,3249,-1,1,chrXI
397343,398750,1407,-1,1,chrXI
392525,393140,615,-1,1,chrXI
390239,392279,2040,-1,1,chrXI
388166,388487,321,-1,1,chrXI
387818,388121,303,-1,1,chrXI
382715,384725,2010,-1,1,chrXI
369527,369920,393,-1,1,chrXI
347213,349136,1923,-1,1,chrXI
342851,345620,2769,-1,1,chrXI
336536,338753,2217,-1,1,chrXI
321014,321518,504,-1,1,chrXI
316436,317057,621,-1,1,chrXI
292955,294308,1353,-1,1,chrXI
281024,282329,1305,-1,1,chrXI
275651,275954,303,-1,1,chrXI
274445,274760,315,-1,1,chrXI
269717,270650,933,-1,1,chrXI
266144,269459,3315,-1,1,chrXI
255719,256472,753,-1,1,chrXI
246137,247682,1545,-1,1,chrXI
228938,229880,942,-1,1,chrXI
224726,225875,1149,-1,1,chrXI
195287,196028,741,-1,1,chrXI
191678,193070,1392,-1,1,chrXI
185285,185681,396,-1,1,chrXI
159455,161342,1887,-1,1,chrXI
153815,154451,636,-1,1,chrXI
147629,148838,1209,-1,1,chrXI
119282,119747,465,-1,1,chrXI
115499,117986,2487,-1,1,chrXI
80159,80537,378,-1,1,chrXI
70733,73865,3132,-1,1,chrXI
68231,70220,1989,-1,1,chrXI
63929,67466,3537,-1,1,chrXI
55934,63359,7425,-1,1,chrXI
42422,46295,3873,-1,1,chrXI
36698,38153,1455,-1,1,chrXI
633025,635179,2154,-1,2,chrXI
612664,613885,1221,-1,2,chrXI
605632,608365,2733,-1,2,chrXI
591505,592540,1035,-1,2,chrXI
583813,584113,300,-1,2,chrXI
579826,580750,924,-1,2,chrXI
574933,575980,1047,-1,2,chrXI
560788,562297,1509,-1,2,chrXI
532549,533464,915,-1,2,chrXI
523417,523993,576,-1,2,chrXI
518062,518566,504,-1,2,chrXI
507919,508561,642,-1,2,chrXI
506878,507304,426,-1,2,chrXI
501343,506395,5052,-1,2,chrXI
488737,489655,918,-1,2,chrXI
485143,487372,2229,-1,2,chrXI
482170,483139,969,-1,2,chrXI
476215,478063,1848,-1,2,chrXI
473722,475900,2178,-1,2,chrXI
466960,468667,1707,-1,2,chrXI
463738,464116,378,-1,2,chrXI
458923,461239,2316,-1,2,chrXI
454351,457054,2703,-1,2,chrXI
427294,428551,1257,-1,2,chrXI
421423,425875,4452,-1,2,chrXI
420154,421216,1062,-1,2,chrXI
407464,407989,525,-1,2,chrXI
403579,403879,300,-1,2,chrXI
386836,387187,351,-1,2,chrXI
376300,376639,339,-1,2,chrXI
361057,361828,771,-1,2,chrXI
351274,352624,1350,-1,2,chrXI
339667,340546,879,-1,2,chrXI
337039,337711,672,-1,2,chrXI
335320,336157,837,-1,2,chrXI
334411,334915,504,-1,2,chrXI
328117,329443,1326,-1,2,chrXI
326407,327487,1080,-1,2,chrXI
298579,299056,477,-1,2,chrXI
297199,297526,327,-1,2,chrXI
292837,293221,384,-1,2,chrXI
276307,276619,312,-1,2,chrXI
258502,258913,411,-1,2,chrXI
257149,257650,501,-1,2,chrXI
253696,255460,1764,-1,2,chrXI
228463,228799,336,-1,2,chrXI
223351,224455,1104,-1,2,chrXI
222892,223285,393,-1,2,chrXI
218569,219217,648,-1,2,chrXI
212494,212998,504,-1,2,chrXI
196348,200167,3819,-1,2,chrXI
193573,194866,1293,-1,2,chrXI
171550,172168,618,-1,2,chrXI
167611,168829,1218,-1,2,chrXI
141793,142819,1026,-1,2,chrXI
133720,134134,414,-1,2,chrXI
131287,133492,2205,-1,2,chrXI
130684,131068,384,-1,2,chrXI
120379,122236,1857,-1,2,chrXI
92743,93298,555,-1,2,chrXI
86224,88786,2562,-1,2,chrXI
78865,79882,1017,-1,2,chrXI
77257,78646,1389,-1,2,chrXI
68536,68902,366,-1,2,chrXI
31081,31693,612,-1,2,chrXI
3502,5620,2118,-1,2,chrXI
1611,2226,615,1,0,chrXII
2595,2931,336,1,0,chrXII
7254,7761,507,1,0,chrXII
8130,8466,336,1,0,chrXII
17955,19707,1752,1,0,chrXII
23568,25296,1728,1,0,chrXII
30108,31704,1596,1,0,chrXII
40665,41205,540,1,0,chrXII
46671,47055,384,1,0,chrXII
47976,48402,426,1,0,chrXII
66561,66942,381,1,0,chrXII
87402,88155,753,1,0,chrXII
94746,95121,375,1,0,chrXII
96813,97461,648,1,0,chrXII
112233,112545,312,1,0,chrXII
141072,142923,1851,1,0,chrXII
164391,165402,1011,1,0,chrXII
166536,167136,600,1,0,chrXII
194451,195174,723,1,0,chrXII
203289,204081,792,1,0,chrXII
204990,208500,3510,1,0,chrXII
247200,247953,753,1,0,chrXII
253860,254958,1098,1,0,chrXII
260004,260355,351,1,0,chrXII
264156,265254,1098,1,0,chrXII
265455,266277,822,1,0,chrXII
266547,266868,321,1,0,chrXII
267168,267723,555,1,0,chrXII
273459,273834,375,1,0,chrXII
290211,291936,1725,1,0,chrXII
307371,307725,354,1,0,chrXII
308295,308598,303,1,0,chrXII
310788,311088,300,1,0,chrXII
311109,311433,324,1,0,chrXII
320700,322080,1380,1,0,chrXII
322296,323178,882,1,0,chrXII
332589,336033,3444,1,0,chrXII
346584,346980,396,1,0,chrXII
369642,370104,462,1,0,chrXII
371619,372927,1308,1,0,chrXII
385533,386175,642,1,0,chrXII
391599,391944,345,1,0,chrXII
393483,393894,411,1,0,chrXII
408444,410193,1749,1,0,chrXII
413280,415527,2247,1,0,chrXII
434640,437397,2757,1,0,chrXII
440466,441288,822,1,0,chrXII
454695,455070,375,1,0,chrXII
465987,466338,351,1,0,chrXII
500334,500688,354,1,0,chrXII
506133,507585,1452,1,0,chrXII
511053,512940,1887,1,0,chrXII
522105,522453,348,1,0,chrXII
532668,533055,387,1,0,chrXII
546096,547611,1515,1,0,chrXII
554577,556419,1842,1,0,chrXII
568566,570627,2061,1,0,chrXII
589353,590541,1188,1,0,chrXII
607455,607983,528,1,0,chrXII
612366,614163,1797,1,0,chrXII
614754,616191,1437,1,0,chrXII
617532,620160,2628,1,0,chrXII
620472,622821,2349,1,0,chrXII
627117,628197,1080,1,0,chrXII
634251,636084,1833,1,0,chrXII
641463,642057,594,1,0,chrXII
652917,653385,468,1,0,chrXII
680199,680844,645,1,0,chrXII
691554,693882,2328,1,0,chrXII
730824,731559,735,1,0,chrXII
747936,748875,939,1,0,chrXII
765654,766089,435,1,0,chrXII
771939,776304,4365,1,0,chrXII
777627,777942,315,1,0,chrXII
779214,780786,1572,1,0,chrXII
804345,805203,858,1,0,chrXII
807384,808818,1434,1,0,chrXII
816093,817761,1668,1,0,chrXII
827520,828027,507,1,0,chrXII
828729,829380,651,1,0,chrXII
834351,836163,1812,1,0,chrXII
844281,845730,1449,1,0,chrXII
846102,847422,1320,1,0,chrXII
854061,854391,330,1,0,chrXII
855198,855531,333,1,0,chrXII
855537,855843,306,1,0,chrXII
859551,861525,1974,1,0,chrXII
862713,866784,4071,1,0,chrXII
876921,877296,375,1,0,chrXII
903723,904440,717,1,0,chrXII
916227,916614,387,1,0,chrXII
919920,920274,354,1,0,chrXII
922062,922536,474,1,0,chrXII
923487,923802,315,1,0,chrXII
982893,986817,3924,1,0,chrXII
987612,988113,501,1,0,chrXII
1006245,1006995,750,1,0,chrXII
1012500,1013775,1275,1,0,chrXII
1024188,1024593,405,1,0,chrXII
1030833,1032012,1179,1,0,chrXII
1036092,1038753,2661,1,0,chrXII
1043997,1051884,7887,1,0,chrXII
1062918,1063281,363,1,0,chrXII
11725,12076,351,1,1,chrXII
54688,55030,342,1,1,chrXII
56368,56974,606,1,1,chrXII
72097,72469,372,1,1,chrXII
73408,74101,693,1,1,chrXII
81460,83710,2250,1,1,chrXII
112846,115993,3147,1,1,chrXII
116431,121111,4680,1,1,chrXII
121321,121648,327,1,1,chrXII
125533,127255,1722,1,1,chrXII
127522,128992,1470,1,1,chrXII
131728,133987,2259,1,1,chrXII
136585,137866,1281,1,1,chrXII
143200,146041,2841,1,1,chrXII
146290,147601,1311,1,1,chrXII
147889,150163,2274,1,1,chrXII
160048,161434,1386,1,1,chrXII
169102,169678,576,1,1,chrXII
172936,173320,384,1,1,chrXII
177607,178621,1014,1,1,chrXII
182272,182596,324,1,1,chrXII
183622,184162,540,1,1,chrXII
251806,252130,324,1,1,chrXII
274426,274795,369,1,1,chrXII
286819,287674,855,1,1,chrXII
302242,306499,4257,1,1,chrXII
328033,328357,324,1,1,chrXII
328360,328690,330,1,1,chrXII
329938,330388,450,1,1,chrXII
338140,338461,321,1,1,chrXII
341809,342853,1044,1,1,chrXII
350566,351196,630,1,1,chrXII
356953,357463,510,1,1,chrXII
370390,370723,333,1,1,chrXII
380821,382252,1431,1,1,chrXII
399028,399433,405,1,1,chrXII
410722,412414,1692,1,1,chrXII
423682,424774,1092,1,1,chrXII
425185,426616,1431,1,1,chrXII
456850,457201,351,1,1,chrXII
485344,485689,345,1,1,chrXII
493882,494389,507,1,1,chrXII
498946,499405,459,1,1,chrXII
502420,504247,1827,1,1,chrXII
517939,520351,2412,1,1,chrXII
535213,536689,1476,1,1,chrXII
537271,538432,1161,1,1,chrXII
543967,545698,1731,1,1,chrXII
555382,555718,336,1,1,chrXII
572908,573232,324,1,1,chrXII
574150,576337,2187,1,1,chrXII
593437,594760,1323,1,1,chrXII
604573,604879,306,1,1,chrXII
606829,607177,348,1,1,chrXII
624202,625021,819,1,1,chrXII
641956,642262,306,1,1,chrXII
646414,650923,4509,1,1,chrXII
658825,659791,966,1,1,chrXII
660715,662833,2118,1,1,chrXII
670339,672823,2484,1,1,chrXII
678211,679924,1713,1,1,chrXII
704308,704698,390,1,1,chrXII
707359,708145,786,1,1,chrXII
722977,723304,327,1,1,chrXII
732541,733876,1335,1,1,chrXII
752953,753358,405,1,1,chrXII
782173,782896,723,1,1,chrXII
784912,786118,1206,1,1,chrXII
786730,787333,603,1,1,chrXII
787663,789679,2016,1,1,chrXII
790675,791806,1131,1,1,chrXII
820510,822040,1530,1,1,chrXII
826093,826393,300,1,1,chrXII
831115,833539,2424,1,1,chrXII
841330,844000,2670,1,1,chrXII
849802,852019,2217,1,1,chrXII
857539,859336,1797,1,1,chrXII
871696,872728,1032,1,1,chrXII
878281,879508,1227,1,1,chrXII
883372,883735,363,1,1,chrXII
903931,904390,459,1,1,chrXII
907078,907918,840,1,1,chrXII
913627,914041,414,1,1,chrXII
925567,927619,2052,1,1,chrXII
929788,930892,1104,1,1,chrXII
935776,936184,408,1,1,chrXII
937540,940981,3441,1,1,chrXII
941482,942799,1317,1,1,chrXII
948367,949192,825,1,1,chrXII
955009,956710,1701,1,1,chrXII
963784,964879,1095,1,1,chrXII
965896,971695,5799,1,1,chrXII
977902,978217,315,1,1,chrXII
993433,1000129,6696,1,1,chrXII
1000360,1000768,408,1,1,chrXII
1002556,1004128,1572,1,1,chrXII
1014490,1015450,960,1,1,chrXII
1040830,1041160,330,1,1,chrXII
1053628,1054543,915,1,1,chrXII
1056454,1056835,381,1,1,chrXII
1057333,1058518,1185,1,1,chrXII
1065955,1066564,609,1,1,chrXII
1067086,1071235,4149,1,1,chrXII
1072507,1077898,5391,1,1,chrXII
842,1325,483,1,2,chrXII
1625,2309,684,1,2,chrXII
6485,6968,483,1,2,chrXII
7268,7844,576,1,2,chrXII
30506,30830,324,1,2,chrXII
47834,48134,300,1,2,chrXII
48215,48662,447,1,2,chrXII
49937,51947,2010,1,2,chrXII
68579,70478,1899,1,2,chrXII
84803,86564,1761,1,2,chrXII
88622,91349,2727,1,2,chrXII
100946,105347,4401,1,2,chrXII
155768,156164,396,1,2,chrXII
171338,171764,426,1,2,chrXII
175226,176744,1518,1,2,chrXII
180287,181481,1194,1,2,chrXII
204224,204785,561,1,2,chrXII
208760,210269,1509,1,2,chrXII
214082,214397,315,1,2,chrXII
229376,229697,321,1,2,chrXII
255305,257855,2550,1,2,chrXII
260978,262766,1788,1,2,chrXII
271007,271463,456,1,2,chrXII
277484,277799,315,1,2,chrXII
277841,278150,309,1,2,chrXII
278861,280943,2082,1,2,chrXII
282926,283592,666,1,2,chrXII
283871,285623,1752,1,2,chrXII
287915,289250,1335,1,2,chrXII
292514,292907,393,1,2,chrXII
316106,317951,1845,1,2,chrXII
323543,326225,2682,1,2,chrXII
364115,365330,1215,1,2,chrXII
368780,369311,531,1,2,chrXII
370790,371210,420,1,2,chrXII
377984,380564,2580,1,2,chrXII
399656,402488,2832,1,2,chrXII
405455,405761,306,1,2,chrXII
417005,418109,1104,1,2,chrXII
418436,421394,2958,1,2,chrXII
423473,423800,327,1,2,chrXII
427328,429386,2058,1,2,chrXII
432167,432773,606,1,2,chrXII
446819,447161,342,1,2,chrXII
463832,464207,375,1,2,chrXII
472112,472457,345,1,2,chrXII
488996,489341,345,1,2,chrXII
489572,489929,357,1,2,chrXII
500732,501122,390,1,2,chrXII
504590,505829,1239,1,2,chrXII
515261,516410,1149,1,2,chrXII
523631,524390,759,1,2,chrXII
524864,527945,3081,1,2,chrXII
528299,530387,2088,1,2,chrXII
547979,548312,333,1,2,chrXII
549011,549356,345,1,2,chrXII
552269,552605,336,1,2,chrXII
556787,559289,2502,1,2,chrXII
559550,560444,894,1,2,chrXII
562007,563390,1383,1,2,chrXII
576824,577793,969,1,2,chrXII
586463,587573,1110,1,2,chrXII
595238,598706,3468,1,2,chrXII
609782,611753,1971,1,2,chrXII
636779,639914,3135,1,2,chrXII
640316,641021,705,1,2,chrXII
642626,644336,1710,1,2,chrXII
651116,652439,1323,1,2,chrXII
654176,656387,2211,1,2,chrXII
665843,667907,2064,1,2,chrXII
681185,682238,1053,1,2,chrXII
682736,683561,825,1,2,chrXII
705185,706130,945,1,2,chrXII
714299,714686,387,1,2,chrXII
715088,717026,1938,1,2,chrXII
724043,724433,390,1,2,chrXII
724856,725213,357,1,2,chrXII
726068,728051,1983,1,2,chrXII
728954,730301,1347,1,2,chrXII
736511,736955,444,1,2,chrXII
740873,741173,300,1,2,chrXII
745619,746525,906,1,2,chrXII
759479,760241,762,1,2,chrXII
764807,765269,462,1,2,chrXII
766541,769196,2655,1,2,chrXII
797429,799592,2163,1,2,chrXII
805886,806825,939,1,2,chrXII
809996,815627,5631,1,2,chrXII
840320,840914,594,1,2,chrXII
867353,868391,1038,1,2,chrXII
879722,881924,2202,1,2,chrXII
885287,888632,3345,1,2,chrXII
893627,896270,2643,1,2,chrXII
903065,903404,339,1,2,chrXII
907949,909398,1449,1,2,chrXII
928742,929600,858,1,2,chrXII
932966,933653,687,1,2,chrXII
942755,946796,4041,1,2,chrXII
947252,947978,726,1,2,chrXII
951155,953183,2028,1,2,chrXII
958427,962735,4308,1,2,chrXII
973394,975521,2127,1,2,chrXII
988427,990440,2013,1,2,chrXII
990776,992732,1956,1,2,chrXII
1000079,1000379,300,1,2,chrXII
1022624,1023971,1347,1,2,chrXII
1025213,1026515,1302,1,2,chrXII
1032626,1035764,3138,1,2,chrXII
1055069,1055684,615,1,2,chrXII
1066571,1067222,651,1,2,chrXII
1069571,1070147,576,1,2,chrXII
1076234,1076810,576,1,2,chrXII
1077049,1077532,483,-1,0,chrXII
1076173,1076749,576,-1,0,chrXII
1073665,1074016,351,-1,0,chrXII
1070386,1070869,483,-1,0,chrXII
1069510,1070086,576,-1,0,chrXII
1067044,1067353,309,-1,0,chrXII
1066264,1066816,552,-1,0,chrXII
1035142,1035466,324,-1,0,chrXII
1023685,1023988,303,-1,0,chrXII
1019314,1022251,2937,-1,0,chrXII
1015567,1017697,2130,-1,0,chrXII
1006024,1006408,384,-1,0,chrXII
990616,990961,345,-1,0,chrXII
980092,981409,1317,-1,0,chrXII
965089,965560,471,-1,0,chrXII
954490,954889,399,-1,0,chrXII
952108,952531,423,-1,0,chrXII
951268,951847,579,-1,0,chrXII
944674,944989,315,-1,0,chrXII
922441,924448,2007,-1,0,chrXII
910234,912310,2076,-1,0,chrXII
908569,908929,360,-1,0,chrXII
888850,892900,4050,-1,0,chrXII
888175,888481,306,-1,0,chrXII
873745,874792,1047,-1,0,chrXII
847387,849124,1737,-1,0,chrXII
822286,822592,306,-1,0,chrXII
816295,816652,357,-1,0,chrXII
805783,806335,552,-1,0,chrXII
804091,804415,324,-1,0,chrXII
802849,803233,384,-1,0,chrXII
799696,802396,2700,-1,0,chrXII
799111,799471,360,-1,0,chrXII
788623,789331,708,-1,0,chrXII
765265,765757,492,-1,0,chrXII
762574,764137,1563,-1,0,chrXII
757636,758833,1197,-1,0,chrXII
757264,757612,348,-1,0,chrXII
738160,743863,5703,-1,0,chrXII
735211,737548,2337,-1,0,chrXII
732868,733333,465,-1,0,chrXII
732190,732553,363,-1,0,chrXII
724720,725416,696,-1,0,chrXII
719788,720370,582,-1,0,chrXII
713479,714904,1425,-1,0,chrXII
705070,705412,342,-1,0,chrXII
704482,704833,351,-1,0,chrXII
683671,687202,3531,-1,0,chrXII
668236,668563,327,-1,0,chrXII
663283,665002,1719,-1,0,chrXII
647245,647557,312,-1,0,chrXII
582232,585490,3258,-1,0,chrXII
572095,573211,1116,-1,0,chrXII
570775,571858,1083,-1,0,chrXII
566653,567922,1269,-1,0,chrXII
564859,566281,1422,-1,0,chrXII
563791,564214,423,-1,0,chrXII
547852,548515,663,-1,0,chrXII
547285,547645,360,-1,0,chrXII
541936,543304,1368,-1,0,chrXII
540808,541573,765,-1,0,chrXII
528349,528826,477,-1,0,chrXII
507796,510232,2436,-1,0,chrXII
501259,502162,903,-1,0,chrXII
500578,501049,471,-1,0,chrXII
482548,483637,1089,-1,0,chrXII
476332,479800,3468,-1,0,chrXII
442957,444688,1731,-1,0,chrXII
429676,432016,2340,-1,0,chrXII
419383,419719,336,-1,0,chrXII
418546,418858,312,-1,0,chrXII
411259,411841,582,-1,0,chrXII
410749,411067,318,-1,0,chrXII
404509,406822,2313,-1,0,chrXII
402793,404062,1269,-1,0,chrXII
400747,401299,552,-1,0,chrXII
384724,385408,684,-1,0,chrXII
342565,342961,396,-1,0,chrXII
326512,327268,756,-1,0,chrXII
292393,293572,1179,-1,0,chrXII
288124,288526,402,-1,0,chrXII
280237,280894,657,-1,0,chrXII
279451,279787,336,-1,0,chrXII
275377,278626,3249,-1,0,chrXII
248716,250255,1539,-1,0,chrXII
238000,238813,813,-1,0,chrXII
235036,237703,2667,-1,0,chrXII
228907,229582,675,-1,0,chrXII
219385,220708,1323,-1,0,chrXII
212368,214456,2088,-1,0,chrXII
210511,211933,1422,-1,0,chrXII
196828,198127,1299,-1,0,chrXII
185497,187129,1632,-1,0,chrXII
175570,175957,387,-1,0,chrXII
172267,174982,2715,-1,0,chrXII
169981,170350,369,-1,0,chrXII
157933,159505,1572,-1,0,chrXII
154342,156334,1992,-1,0,chrXII
122074,124714,2640,-1,0,chrXII
105685,107899,2214,-1,0,chrXII
102415,102889,474,-1,0,chrXII
99043,100201,1158,-1,0,chrXII
97996,98836,840,-1,0,chrXII
74269,76747,2478,-1,0,chrXII
35911,36361,450,-1,0,chrXII
14647,16072,1425,-1,0,chrXII
7207,7783,576,-1,0,chrXII
1564,2248,684,-1,0,chrXII
1076256,1076763,507,-1,1,chrXII
1075551,1075887,336,-1,1,chrXII
1069593,1070100,507,-1,1,chrXII
1068888,1069224,336,-1,1,chrXII
1059756,1060887,1131,-1,1,chrXII
1055811,1056771,960,-1,1,chrXII
1041798,1042986,1188,-1,1,chrXII
1039269,1041366,2097,-1,1,chrXII
1026855,1027893,1038,-1,1,chrXII
1018140,1018908,768,-1,1,chrXII
1014615,1014936,321,-1,1,chrXII
1011621,1012023,402,-1,1,chrXII
1004346,1006008,1662,-1,1,chrXII
1000341,1001703,1362,-1,1,chrXII
999090,999462,372,-1,1,chrXII
976611,980136,3525,-1,1,chrXII
971916,973170,1254,-1,1,chrXII
970896,971394,498,-1,1,chrXII
956913,958095,1182,-1,1,chrXII
954258,954597,339,-1,1,chrXII
953352,954144,792,-1,1,chrXII
934413,937233,2820,-1,1,chrXII
912549,914892,2343,-1,1,chrXII
896373,897672,1299,-1,1,chrXII
882066,884751,2685,-1,1,chrXII
871452,871842,390,-1,1,chrXII
861717,862254,537,-1,1,chrXII
858489,858843,354,-1,1,chrXII
843486,844050,564,-1,1,chrXII
838065,839253,1188,-1,1,chrXII
836349,837357,1008,-1,1,chrXII
829488,830364,876,-1,1,chrXII
823827,826413,2586,-1,1,chrXII
791409,791748,339,-1,1,chrXII
790668,791046,378,-1,1,chrXII
788475,789315,840,-1,1,chrXII
776583,777864,1281,-1,1,chrXII
769317,771684,2367,-1,1,chrXII
760749,762342,1593,-1,1,chrXII
752223,756993,4770,-1,1,chrXII
721998,722373,375,-1,1,chrXII
717144,717978,834,-1,1,chrXII
708447,710136,1689,-1,1,chrXII
706197,707040,843,-1,1,chrXII
697155,699495,2340,-1,1,chrXII
689082,691029,1947,-1,1,chrXII
680865,681216,351,-1,1,chrXII
675618,677724,2106,-1,1,chrXII
644403,644973,570,-1,1,chrXII
628683,633354,4671,-1,1,chrXII
625167,626331,1164,-1,1,chrXII
622917,623883,966,-1,1,chrXII
611793,612117,324,-1,1,chrXII
610359,610665,306,-1,1,chrXII
605757,607119,1362,-1,1,chrXII
600018,602463,2445,-1,1,chrXII
587694,588918,1224,-1,1,chrXII
578361,579024,663,-1,1,chrXII
573465,573918,453,-1,1,chrXII
560796,561732,936,-1,1,chrXII
552723,553677,954,-1,1,chrXII
549510,550293,783,-1,1,chrXII
545067,545448,381,-1,1,chrXII
538791,539589,798,-1,1,chrXII
530796,534393,3597,-1,1,chrXII
520542,522012,1470,-1,1,chrXII
518274,518583,309,-1,1,chrXII
514107,514713,606,-1,1,chrXII
494493,495258,765,-1,1,chrXII
491865,493254,1389,-1,1,chrXII
472968,474057,1089,-1,1,chrXII
447981,448314,333,-1,1,chrXII
441714,442737,1023,-1,1,chrXII
434157,434463,306,-1,1,chrXII
432822,433725,903,-1,1,chrXII
420852,421182,330,-1,1,chrXII
419793,420132,339,-1,1,chrXII
415800,416658,858,-1,1,chrXII
395757,398319,2562,-1,1,chrXII
394764,395520,756,-1,1,chrXII
391077,391407,330,-1,1,chrXII
388743,390270,1527,-1,1,chrXII
382470,384534,2064,-1,1,chrXII
374943,377238,2295,-1,1,chrXII
369696,370098,402,-1,1,chrXII
366666,368124,1458,-1,1,chrXII
349005,363738,14733,-1,1,chrXII
347046,348180,1134,-1,1,chrXII
342969,343767,798,-1,1,chrXII
329676,332115,2439,-1,1,chrXII
327729,329238,1509,-1,1,chrXII
322854,323154,300,-1,1,chrXII
304776,305142,366,-1,1,chrXII
300672,301989,1317,-1,1,chrXII
294090,296094,2004,-1,1,chrXII
285735,286131,396,-1,1,chrXII
281955,282456,501,-1,1,chrXII
274140,275211,1071,-1,1,chrXII
271629,273915,2286,-1,1,chrXII
259737,260547,810,-1,1,chrXII
257991,259401,1410,-1,1,chrXII
251271,253080,1809,-1,1,chrXII
245586,246072,486,-1,1,chrXII
243885,245172,1287,-1,1,chrXII
239346,241407,2061,-1,1,chrXII
232389,234081,1692,-1,1,chrXII
229965,230451,486,-1,1,chrXII
222684,223059,375,-1,1,chrXII
221520,222132,612,-1,1,chrXII
215439,218907,3468,-1,1,chrXII
201975,202590,615,-1,1,chrXII
199539,201315,1776,-1,1,chrXII
187662,193281,5619,-1,1,chrXII
184173,184926,753,-1,1,chrXII
181788,183405,1617,-1,1,chrXII
167319,167802,483,-1,1,chrXII
165576,166083,507,-1,1,chrXII
161754,163893,2139,-1,1,chrXII
160125,160509,384,-1,1,chrXII
134301,136299,1998,-1,1,chrXII
132498,132822,324,-1,1,chrXII
119331,119718,387,-1,1,chrXII
105555,105861,306,-1,1,chrXII
95565,97485,1920,-1,1,chrXII
87531,87870,339,-1,1,chrXII
80355,80697,342,-1,1,chrXII
77151,80205,3054,-1,1,chrXII
70632,73146,2514,-1,1,chrXII
66744,68256,1512,-1,1,chrXII
54210,63645,9435,-1,1,chrXII
53130,53931,801,-1,1,chrXII
52086,52590,504,-1,1,chrXII
46713,47463,750,-1,1,chrXII
37332,39471,2139,-1,1,chrXII
35502,35961,459,-1,1,chrXII
27408,28305,897,-1,1,chrXII
25755,26994,1239,-1,1,chrXII
22473,22980,507,-1,1,chrXII
16638,17613,975,-1,1,chrXII
1047311,1047644,333,-1,2,chrXII
1031375,1031918,543,-1,2,chrXII
1007420,1011245,3825,-1,2,chrXII
990893,991223,330,-1,2,chrXII
933884,934253,369,-1,2,chrXII
919535,921596,2061,-1,2,chrXII
915155,919019,3864,-1,2,chrXII
904748,906305,1557,-1,2,chrXII
899576,902660,3084,-1,2,chrXII
892991,893390,399,-1,2,chrXII
875735,877178,1443,-1,2,chrXII
872825,873554,729,-1,2,chrXII
868661,871367,2706,-1,2,chrXII
860981,861419,438,-1,2,chrXII
852494,853151,657,-1,2,chrXII
826976,827873,897,-1,2,chrXII
810107,810560,453,-1,2,chrXII
802652,805106,2454,-1,2,chrXII
796697,797078,381,-1,2,chrXII
795572,795899,327,-1,2,chrXII
780347,780758,411,-1,2,chrXII
778172,778952,780,-1,2,chrXII
749033,751769,2736,-1,2,chrXII
721700,722030,330,-1,2,chrXII
720770,721430,660,-1,2,chrXII
718316,719462,1146,-1,2,chrXII
710990,712058,1068,-1,2,chrXII
704492,704960,468,-1,2,chrXII
699998,704024,4026,-1,2,chrXII
695045,696830,1785,-1,2,chrXII
674426,675455,1029,-1,2,chrXII
668243,668891,648,-1,2,chrXII
645599,645953,354,-1,2,chrXII
643382,643718,336,-1,2,chrXII
636830,637175,345,-1,2,chrXII
626501,626930,429,-1,2,chrXII
618527,618962,435,-1,2,chrXII
616331,617318,987,-1,2,chrXII
611531,611930,399,-1,2,chrXII
607424,609524,2100,-1,2,chrXII
604211,604787,576,-1,2,chrXII
590561,592043,1482,-1,2,chrXII
579317,581771,2454,-1,2,chrXII
550649,551960,1311,-1,2,chrXII
540008,540536,528,-1,2,chrXII
516677,517670,993,-1,2,chrXII
515357,515696,339,-1,2,chrXII
513161,513821,660,-1,2,chrXII
499577,500270,693,-1,2,chrXII
495428,498044,2616,-1,2,chrXII
486200,487289,1089,-1,2,chrXII
480278,481601,1323,-1,2,chrXII
469316,470405,1089,-1,2,chrXII
445523,447575,2052,-1,2,chrXII
437630,439823,2193,-1,2,chrXII
424361,424736,375,-1,2,chrXII
421541,423473,1932,-1,2,chrXII
407282,408155,873,-1,2,chrXII
390953,391331,378,-1,2,chrXII
386510,388220,1710,-1,2,chrXII
374975,375476,501,-1,2,chrXII
343988,345941,1953,-1,2,chrXII
339743,340928,1185,-1,2,chrXII
337526,339473,1947,-1,2,chrXII
336230,337265,1035,-1,2,chrXII
321218,321770,552,-1,2,chrXII
318236,320015,1779,-1,2,chrXII
306854,315731,8877,-1,2,chrXII
296588,300251,3663,-1,2,chrXII
283184,283607,423,-1,2,chrXII
281018,281621,603,-1,2,chrXII
267812,270710,2898,-1,2,chrXII
266372,266918,546,-1,2,chrXII
263576,263954,378,-1,2,chrXII
248099,248426,327,-1,2,chrXII
247571,247946,375,-1,2,chrXII
246323,246977,654,-1,2,chrXII
231701,232013,312,-1,2,chrXII
225425,228596,3171,-1,2,chrXII
217244,217637,393,-1,2,chrXII
205730,206108,378,-1,2,chrXII
195449,196472,1023,-1,2,chrXII
178706,179606,900,-1,2,chrXII
176801,177416,615,-1,2,chrXII
156854,157730,876,-1,2,chrXII
151388,153977,2589,-1,2,chrXII
141521,141839,318,-1,2,chrXII
137939,140546,2607,-1,2,chrXII
129329,130613,1284,-1,2,chrXII
109901,111575,1674,-1,2,chrXII
65774,66518,744,-1,2,chrXII
64061,65207,1146,-1,2,chrXII
50060,50438,378,-1,2,chrXII
47858,48629,771,-1,2,chrXII
41279,46265,4986,-1,2,chrXII
39803,40274,471,-1,2,chrXII
32672,35204,2532,-1,2,chrXII
31025,31397,372,-1,2,chrXII
24245,24656,411,-1,2,chrXII
21137,21839,702,-1,2,chrXII
13082,13445,363,-1,2,chrXII
9527,10343,816,-1,2,chrXII
6119,9113,2994,-1,2,chrXII
3992,4808,816,-1,2,chrXII
584,3578,2994,-1,2,chrXII
10197,11295,1098,1,0,chrXIII
19791,20172,381,1,0,chrXIII
28665,29004,339,1,0,chrXIII
34242,37647,3405,1,0,chrXIII
46941,49704,2763,1,0,chrXIII
50376,50688,312,1,0,chrXIII
51639,54468,2829,1,0,chrXIII
54792,55110,318,1,0,chrXIII
56772,57453,681,1,0,chrXIII
70623,73920,3297,1,0,chrXIII
79908,81486,1578,1,0,chrXIII
111864,112344,480,1,0,chrXIII
115986,116370,384,1,0,chrXIII
140547,140862,315,1,0,chrXIII
142209,144954,2745,1,0,chrXIII
146481,147249,768,1,0,chrXIII
160179,161994,1815,1,0,chrXIII
178425,179637,1212,1,0,chrXIII
179892,180258,366,1,0,chrXIII
181473,183363,1890,1,0,chrXIII
186261,189729,3468,1,0,chrXIII
205641,206211,570,1,0,chrXIII
214188,216156,1968,1,0,chrXIII
220137,220728,591,1,0,chrXIII
228936,229500,564,1,0,chrXIII
234912,235236,324,1,0,chrXIII
236994,238731,1737,1,0,chrXIII
248013,248388,375,1,0,chrXIII
250434,250911,477,1,0,chrXIII
260220,261609,1389,1,0,chrXIII
264540,266754,2214,1,0,chrXIII
273117,273714,597,1,0,chrXIII
281598,281967,369,1,0,chrXIII
285099,286317,1218,1,0,chrXIII
288078,289704,1626,1,0,chrXIII
307488,308682,1194,1,0,chrXIII
319755,320055,300,1,0,chrXIII
330792,331923,1131,1,0,chrXIII
352602,353136,534,1,0,chrXIII
355383,356811,1428,1,0,chrXIII
388821,390732,1911,1,0,chrXIII
391038,391485,447,1,0,chrXIII
392754,394788,2034,1,0,chrXIII
397902,399459,1557,1,0,chrXIII
434787,435915,1128,1,0,chrXIII
437490,438789,1299,1,0,chrXIII
442638,442977,339,1,0,chrXIII
449244,449928,684,1,0,chrXIII
454014,455556,1542,1,0,chrXIII
466299,468162,1863,1,0,chrXIII
484083,486147,2064,1,0,chrXIII
497703,499209,1506,1,0,chrXIII
499551,499869,318,1,0,chrXIII
505332,507207,1875,1,0,chrXIII
509874,510198,324,1,0,chrXIII
514455,517287,2832,1,0,chrXIII
517869,520446,2577,1,0,chrXIII
523695,527499,3804,1,0,chrXIII
537837,538551,714,1,0,chrXIII
539910,540444,534,1,0,chrXIII
545154,545730,576,1,0,chrXIII
547713,549183,1470,1,0,chrXIII
572247,572715,468,1,0,chrXIII
574470,574791,321,1,0,chrXIII
590427,590751,324,1,0,chrXIII
594885,597195,2310,1,0,chrXIII
608688,609981,1293,1,0,chrXIII
611739,615975,4236,1,0,chrXIII
619857,622134,2277,1,0,chrXIII
628188,628785,597,1,0,chrXIII
654033,654417,384,1,0,chrXIII
662643,664284,1641,1,0,chrXIII
667536,668205,669,1,0,chrXIII
678714,679053,339,1,0,chrXIII
680646,681000,354,1,0,chrXIII
681936,682317,381,1,0,chrXIII
683001,683406,405,1,0,chrXIII
689082,690510,1428,1,0,chrXIII
695268,696483,1215,1,0,chrXIII
696795,698370,1575,1,0,chrXIII
718965,719316,351,1,0,chrXIII
724014,724338,324,1,0,chrXIII
727905,728253,348,1,0,chrXIII
740265,741312,1047,1,0,chrXIII
743748,745923,2175,1,0,chrXIII
746352,747729,1377,1,0,chrXIII
758562,759183,621,1,0,chrXIII
772914,774015,1101,1,0,chrXIII
789381,789732,351,1,0,chrXIII
793725,794667,942,1,0,chrXIII
795804,796416,612,1,0,chrXIII
801771,802704,933,1,0,chrXIII
813081,813513,432,1,0,chrXIII
816552,816867,315,1,0,chrXIII
818826,819948,1122,1,0,chrXIII
822762,824631,1869,1,0,chrXIII
828642,829104,462,1,0,chrXIII
832338,833253,915,1,0,chrXIII
851421,851769,348,1,0,chrXIII
856965,858087,1122,1,0,chrXIII
859407,859722,315,1,0,chrXIII
859830,860130,300,1,0,chrXIII
861921,863520,1599,1,0,chrXIII
867609,868173,564,1,0,chrXIII
874986,878679,3693,1,0,chrXIII
898404,899226,822,1,0,chrXIII
902799,903849,1050,1,0,chrXIII
904824,905835,1011,1,0,chrXIII
826,1309,483,1,1,chrXIII
1609,2185,576,1,1,chrXIII
7243,8383,1140,1,1,chrXIII
26929,27862,933,1,1,chrXIII
30610,31684,1074,1,1,chrXIII
37471,37774,303,1,1,chrXIII
39226,39547,321,1,1,chrXIII
42277,42613,336,1,1,chrXIII
44044,44791,747,1,1,chrXIII
68293,69700,1407,1,1,chrXIII
77266,77770,504,1,1,chrXIII
82471,82849,378,1,1,chrXIII
83089,85789,2700,1,1,chrXIII
104776,108532,3756,1,1,chrXIII
108805,110077,1272,1,1,chrXIII
111001,111550,549,1,1,chrXIII
133474,135229,1755,1,1,chrXIII
135499,137158,1659,1,1,chrXIII
151870,153001,1131,1,1,chrXIII
159382,159697,315,1,1,chrXIII
170401,171310,909,1,1,chrXIII
192787,194800,2013,1,1,chrXIII
196627,197950,1323,1,1,chrXIII
209524,211495,1971,1,1,chrXIII
211714,212155,441,1,1,chrXIII
231148,233143,1995,1,1,chrXIII
246115,246751,636,1,1,chrXIII
263482,264355,873,1,1,chrXIII
284101,284641,540,1,1,chrXIII
291133,294967,3834,1,1,chrXIII
298867,300427,1560,1,1,chrXIII
310207,311752,1545,1,1,chrXIII
315376,316903,1527,1,1,chrXIII
318679,319177,498,1,1,chrXIII
321874,323047,1173,1,1,chrXIII
323299,324187,888,1,1,chrXIII
325876,327289,1413,1,1,chrXIII
327481,328582,1101,1,1,chrXIII
334708,335035,327,1,1,chrXIII
338329,339277,948,1,1,chrXIII
350380,350863,483,1,1,chrXIII
379585,380200,615,1,1,chrXIII
383302,385975,2673,1,1,chrXIII
406303,407584,1281,1,1,chrXIII
409153,410626,1473,1,1,chrXIII
411568,412120,552,1,1,chrXIII
436627,437416,789,1,1,chrXIII
439207,442090,2883,1,1,chrXIII
455824,457261,1437,1,1,chrXIII
458407,459301,894,1,1,chrXIII
483013,483361,348,1,1,chrXIII
484450,484858,408,1,1,chrXIII
486586,490246,3660,1,1,chrXIII
494998,496282,1284,1,1,chrXIII
506995,507370,375,1,1,chrXIII
513592,513961,369,1,1,chrXIII
527803,531817,4014,1,1,chrXIII
536206,537514,1308,1,1,chrXIII
541198,542881,1683,1,1,chrXIII
546124,547237,1113,1,1,chrXIII
559198,559870,672,1,1,chrXIII
560365,560812,447,1,1,chrXIII
560995,561856,861,1,1,chrXIII
563095,564193,1098,1,1,chrXIII
575065,577516,2451,1,1,chrXIII
577717,578392,675,1,1,chrXIII
605980,608140,2160,1,1,chrXIII
608896,610081,1185,1,1,chrXIII
618478,619303,825,1,1,chrXIII
645400,646777,1377,1,1,chrXIII
650035,650812,777,1,1,chrXIII
655075,658342,3267,1,1,chrXIII
668491,669655,1164,1,1,chrXIII
675895,676837,942,1,1,chrXIII
684466,685798,1332,1,1,chrXIII
712315,713671,1356,1,1,chrXIII
751960,752905,945,1,1,chrXIII
757249,758317,1068,1,1,chrXIII
770800,772558,1758,1,1,chrXIII
778000,778567,567,1,1,chrXIII
798517,801379,2862,1,1,chrXIII
820255,822454,2199,1,1,chrXIII
838186,839995,1809,1,1,chrXIII
858208,858568,360,1,1,chrXIII
863818,864271,453,1,1,chrXIII
881158,886516,5358,1,1,chrXIII
887002,888682,1680,1,1,chrXIII
901708,902413,705,1,1,chrXIII
907363,910786,3423,1,1,chrXIII
1595,2102,507,1,2,chrXIII
2471,2807,336,1,2,chrXIII
17063,18809,1746,1,2,chrXIII
32333,33851,1518,1,2,chrXIII
38195,39824,1629,1,2,chrXIII
45062,45953,891,1,2,chrXIII
55991,56309,318,1,2,chrXIII
63044,63404,360,1,2,chrXIII
74228,74558,330,1,2,chrXIII
90743,91130,387,1,2,chrXIII
92234,94241,2007,1,2,chrXIII
99488,99797,309,1,2,chrXIII
101861,103811,1950,1,2,chrXIII
110246,110852,606,1,2,chrXIII
120185,120761,576,1,2,chrXIII
120881,121277,396,1,2,chrXIII
127925,128432,507,1,2,chrXIII
129932,130397,465,1,2,chrXIII
137549,138944,1395,1,2,chrXIII
164789,165326,537,1,2,chrXIII
169415,169748,333,1,2,chrXIII
171593,172901,1308,1,2,chrXIII
173138,174074,936,1,2,chrXIII
184460,185783,1323,1,2,chrXIII
198428,201896,3468,1,2,chrXIII
216434,216914,480,1,2,chrXIII
217361,219878,2517,1,2,chrXIII
221405,222563,1158,1,2,chrXIII
227042,227432,390,1,2,chrXIII
233456,234455,999,1,2,chrXIII
243224,244064,840,1,2,chrXIII
244148,245903,1755,1,2,chrXIII
247676,250868,3192,1,2,chrXIII
253847,255800,1953,1,2,chrXIII
267173,267800,627,1,2,chrXIII
272192,272663,471,1,2,chrXIII
274016,275552,1536,1,2,chrXIII
276044,277211,1167,1,2,chrXIII
279959,280340,381,1,2,chrXIII
312155,315005,2850,1,2,chrXIII
324545,324875,330,1,2,chrXIII
335297,337307,2010,1,2,chrXIII
341141,341675,534,1,2,chrXIII
353870,354731,861,1,2,chrXIII
365336,365648,312,1,2,chrXIII
366980,367934,954,1,2,chrXIII
395600,396002,402,1,2,chrXIII
397076,397796,720,1,2,chrXIII
399701,401216,1515,1,2,chrXIII
401540,404237,2697,1,2,chrXIII
407708,408566,858,1,2,chrXIII
413981,416036,2055,1,2,chrXIII
425366,426059,693,1,2,chrXIII
442526,443381,855,1,2,chrXIII
489398,489908,510,1,2,chrXIII
492659,493172,513,1,2,chrXIII
532118,533027,909,1,2,chrXIII
553361,554390,1029,1,2,chrXIII
562505,562943,438,1,2,chrXIII
564434,565862,1428,1,2,chrXIII
568550,570194,1644,1,2,chrXIII
571589,571973,384,1,2,chrXIII
579686,580010,324,1,2,chrXIII
581117,581429,312,1,2,chrXIII
616565,618098,1533,1,2,chrXIII
629024,631970,2946,1,2,chrXIII
632354,634472,2118,1,2,chrXIII
637499,640604,3105,1,2,chrXIII
647117,649280,2163,1,2,chrXIII
659744,661529,1785,1,2,chrXIII
664751,665522,771,1,2,chrXIII
687515,688865,1350,1,2,chrXIII
693380,695153,1773,1,2,chrXIII
701789,703367,1578,1,2,chrXIII
707132,712109,4977,1,2,chrXIII
716714,718130,1416,1,2,chrXIII
724625,725651,1026,1,2,chrXIII
733544,736634,3090,1,2,chrXIII
736925,738959,2034,1,2,chrXIII
739184,739865,681,1,2,chrXIII
742970,743444,474,1,2,chrXIII
759806,761891,2085,1,2,chrXIII
794918,795524,606,1,2,chrXIII
804455,805091,636,1,2,chrXIII
845570,848486,2916,1,2,chrXIII
848684,849809,1125,1,2,chrXIII
852629,854390,1761,1,2,chrXIII
897164,897524,360,1,2,chrXIII
916745,917051,306,1,2,chrXIII
920087,921401,1314,1,2,chrXIII
922640,923015,375,1,2,chrXIII
918365,919079,714,-1,0,chrXIII
911060,912143,1083,-1,0,chrXIII
899378,901307,1929,-1,0,chrXIII
895715,896669,954,-1,0,chrXIII
879062,880232,1170,-1,0,chrXIII
873290,874337,1047,-1,0,chrXIII
867554,869627,2073,-1,0,chrXIII
859214,860891,1677,-1,0,chrXIII
858296,858890,594,-1,0,chrXIII
855398,856793,1395,-1,0,chrXIII
850073,851591,1518,-1,0,chrXIII
842435,845345,2910,-1,0,chrXIII
840143,841691,1548,-1,0,chrXIII
835325,836867,1542,-1,0,chrXIII
827027,831329,4302,-1,0,chrXIII
811232,813980,2748,-1,0,chrXIII
806864,807548,684,-1,0,chrXIII
805325,806423,1098,-1,0,chrXIII
796004,796322,318,-1,0,chrXIII
789377,789839,462,-1,0,chrXIII
777614,777923,309,-1,0,chrXIII
760364,760754,390,-1,0,chrXIII
758516,758831,315,-1,0,chrXIII
753224,753767,543,-1,0,chrXIII
725933,731123,5190,-1,0,chrXIII
722612,724385,1773,-1,0,chrXIII
721592,722396,804,-1,0,chrXIII
718574,720653,2079,-1,0,chrXIII
715637,716309,672,-1,0,chrXIII
713930,715445,1515,-1,0,chrXIII
710627,710936,309,-1,0,chrXIII
702161,702545,384,-1,0,chrXIII
698810,701039,2229,-1,0,chrXIII
685910,687284,1374,-1,0,chrXIII
677192,683564,6372,-1,0,chrXIII
658544,659198,654,-1,0,chrXIII
651071,651458,387,-1,0,chrXIII
636290,637004,714,-1,0,chrXIII
634688,635984,1296,-1,0,chrXIII
623615,624080,465,-1,0,chrXIII
622250,623213,963,-1,0,chrXIII
599351,600872,1521,-1,0,chrXIII
593366,594473,1107,-1,0,chrXIII
590039,592628,2589,-1,0,chrXIII
587273,589550,2277,-1,0,chrXIII
584270,586388,2118,-1,0,chrXIII
574475,574928,453,-1,0,chrXIII
570299,571016,717,-1,0,chrXIII
557480,558524,1044,-1,0,chrXIII
554792,556475,1683,-1,0,chrXIII
550205,550895,690,-1,0,chrXIII
542009,542345,336,-1,0,chrXIII
538688,540056,1368,-1,0,chrXIII
533162,534698,1536,-1,0,chrXIII
526736,527039,303,-1,0,chrXIII
525104,525422,318,-1,0,chrXIII
520760,521789,1029,-1,0,chrXIII
515936,516530,594,-1,0,chrXIII
494099,494495,396,-1,0,chrXIII
484526,484940,414,-1,0,chrXIII
472901,473264,363,-1,0,chrXIII
469847,472352,2505,-1,0,chrXIII
451631,453479,1848,-1,0,chrXIII
442025,442364,339,-1,0,chrXIII
431768,432125,357,-1,0,chrXIII
416195,420029,3834,-1,0,chrXIII
398516,398864,348,-1,0,chrXIII
388358,388730,372,-1,0,chrXIII
387314,388244,930,-1,0,chrXIII
380345,382898,2553,-1,0,chrXIII
368093,370517,2424,-1,0,chrXIII
365771,366191,420,-1,0,chrXIII
361304,362627,1323,-1,0,chrXIII
347510,348260,750,-1,0,chrXIII
344402,346517,2115,-1,0,chrXIII
341855,343520,1665,-1,0,chrXIII
319436,321017,1581,-1,0,chrXIII
295178,296738,1560,-1,0,chrXIII
280589,282584,1995,-1,0,chrXIII
269018,271136,2118,-1,0,chrXIII
261704,262685,981,-1,0,chrXIII
256091,258416,2325,-1,0,chrXIII
241988,243029,1041,-1,0,chrXIII
234770,235952,1182,-1,0,chrXIII
229733,230813,1080,-1,0,chrXIII
224405,224951,546,-1,0,chrXIII
215639,215999,360,-1,0,chrXIII
214085,214421,336,-1,0,chrXIII
194912,195755,843,-1,0,chrXIII
169115,169754,639,-1,0,chrXIII
160022,160412,390,-1,0,chrXIII
153218,158258,5040,-1,0,chrXIII
148952,151532,2580,-1,0,chrXIII
140423,141533,1110,-1,0,chrXIII
115733,118898,3165,-1,0,chrXIII
97940,98675,735,-1,0,chrXIII
94430,95369,939,-1,0,chrXIII
91040,91409,369,-1,0,chrXIII
87122,90731,3609,-1,0,chrXIII
76697,77021,324,-1,0,chrXIII
70655,71351,696,-1,0,chrXIII
69734,70088,354,-1,0,chrXIII
53291,53834,543,-1,0,chrXIII
50030,50954,924,-1,0,chrXIII
47900,48218,318,-1,0,chrXIII
28265,29807,1542,-1,0,chrXIII
15134,16676,1542,-1,0,chrXIII
917578,917896,318,-1,1,chrXIII
892987,895426,2439,-1,1,chrXIII
878779,879130,351,-1,1,chrXIII
873418,873733,315,-1,1,chrXIII
865558,867091,1533,-1,1,chrXIII
854884,855226,342,-1,1,chrXIII
845647,846244,597,-1,1,chrXIII
824728,826351,1623,-1,1,chrXIII
815650,818581,2931,-1,1,chrXIII
814363,815311,948,-1,1,chrXIII
790204,793369,3165,-1,1,chrXIII
775945,777190,1245,-1,1,chrXIII
754837,756166,1329,-1,1,chrXIII
749929,751240,1311,-1,1,chrXIII
748261,749677,1416,-1,1,chrXIII
741511,742735,1224,-1,1,chrXIII
694309,694624,315,-1,1,chrXIII
690694,693043,2349,-1,1,chrXIII
647173,647518,345,-1,1,chrXIII
626920,627808,888,-1,1,chrXIII
601561,603082,1521,-1,1,chrXIII
597331,599158,1827,-1,1,chrXIII
588331,588754,423,-1,1,chrXIII
578950,583921,4971,-1,1,chrXIII
571276,572044,768,-1,1,chrXIII
565573,565909,336,-1,1,chrXIII
564445,564829,384,-1,1,chrXIII
561955,562528,573,-1,1,chrXIII
553483,553789,306,-1,1,chrXIII
542977,544963,1986,-1,1,chrXIII
534943,535570,627,-1,1,chrXIII
522328,523345,1017,-1,1,chrXIII
510700,511075,375,-1,1,chrXIII
496342,497449,1107,-1,1,chrXIII
492403,493792,1389,-1,1,chrXIII
490393,491992,1599,-1,1,chrXIII
478300,480190,1890,-1,1,chrXIII
473419,475453,2034,-1,1,chrXIII
463933,464827,894,-1,1,chrXIII
443413,445102,1689,-1,1,chrXIII
430078,431095,1017,-1,1,chrXIII
421483,422149,666,-1,1,chrXIII
415687,416053,366,-1,1,chrXIII
413035,413473,438,-1,1,chrXIII
412267,412873,606,-1,1,chrXIII
410761,411265,504,-1,1,chrXIII
397354,397690,336,-1,1,chrXIII
395053,396379,1326,-1,1,chrXIII
391531,392515,984,-1,1,chrXIII
380068,380434,366,-1,1,chrXIII
377002,378325,1323,-1,1,chrXIII
357358,360826,3468,-1,1,chrXIII
350965,351973,1008,-1,1,chrXIII
348643,349522,879,-1,1,chrXIII
324235,325435,1200,-1,1,chrXIII
317164,318418,1254,-1,1,chrXIII
303235,305593,2358,-1,1,chrXIII
300868,302485,1617,-1,1,chrXIII
274777,275353,576,-1,1,chrXIII
255331,255754,423,-1,1,chrXIII
254497,254932,435,-1,1,chrXIII
250303,250672,369,-1,1,chrXIII
245536,245914,378,-1,1,chrXIII
244543,244858,315,-1,1,chrXIII
226993,228664,1671,-1,1,chrXIII
204385,205408,1023,-1,1,chrXIII
202774,204103,1329,-1,1,chrXIII
190243,191767,1524,-1,1,chrXIII
180016,181075,1059,-1,1,chrXIII
165532,167308,1776,-1,1,chrXIII
163705,164176,471,-1,1,chrXIII
162193,163216,1023,-1,1,chrXIII
156262,156577,315,-1,1,chrXIII
145138,145876,738,-1,1,chrXIII
129748,131572,1824,-1,1,chrXIII
124729,129367,4638,-1,1,chrXIII
120088,121324,1236,-1,1,chrXIII
102922,103240,318,-1,1,chrXIII
99793,101050,1257,-1,1,chrXIII
92662,93019,357,-1,1,chrXIII
78334,79690,1356,-1,1,chrXIII
62581,67549,4968,-1,1,chrXIII
57865,58687,822,-1,1,chrXIII
55264,56425,1161,-1,1,chrXIII
40186,41794,1608,-1,1,chrXIII
38440,38791,351,-1,1,chrXIII
11482,13174,1692,-1,1,chrXIII
3868,4684,816,-1,1,chrXIII
460,3454,2994,-1,1,chrXIII
923493,923802,309,-1,2,chrXIII
912879,914538,1659,-1,2,chrXIII
908862,909366,504,-1,2,chrXIII
907794,908841,1047,-1,2,chrXIII
907320,907629,309,-1,2,chrXIII
905661,905973,312,-1,2,chrXIII
896913,897603,690,-1,2,chrXIII
888951,892221,3270,-1,2,chrXIII
888303,888651,348,-1,2,chrXIII
886182,886572,390,-1,2,chrXIII
876348,876648,300,-1,2,chrXIII
870072,872625,2553,-1,2,chrXIII
864411,865350,939,-1,2,chrXIII
862005,862341,336,-1,2,chrXIII
833355,835098,1743,-1,2,chrXIII
809622,810777,1155,-1,2,chrXIII
802887,804222,1335,-1,2,chrXIII
796539,797925,1386,-1,2,chrXIII
784620,788883,4263,-1,2,chrXIII
782619,784281,1662,-1,2,chrXIII
779628,782031,2403,-1,2,chrXIII
775314,775719,405,-1,2,chrXIII
763350,768039,4689,-1,2,chrXIII
703578,706887,3309,-1,2,chrXIII
671886,674766,2880,-1,2,chrXIII
670062,671325,1263,-1,2,chrXIII
665844,666588,744,-1,2,chrXIII
640914,645258,4344,-1,2,chrXIII
624531,625167,636,-1,2,chrXIII
607827,608211,384,-1,2,chrXIII
603867,605520,1653,-1,2,chrXIII
565998,568182,2184,-1,2,chrXIII
549735,550044,309,-1,2,chrXIII
537126,537441,315,-1,2,chrXIII
509733,510348,615,-1,2,chrXIII
507501,509280,1779,-1,2,chrXIII
502143,502734,591,-1,2,chrXIII
501249,501891,642,-1,2,chrXIII
500115,500688,573,-1,2,chrXIII
499455,499755,300,-1,2,chrXIII
489522,489852,330,-1,2,chrXIII
475896,477606,1710,-1,2,chrXIII
468444,469476,1032,-1,2,chrXIII
460770,462609,1839,-1,2,chrXIII
459423,460527,1104,-1,2,chrXIII
457284,457959,675,-1,2,chrXIII
456327,456633,306,-1,2,chrXIII
450057,451365,1308,-1,2,chrXIII
445608,448086,2478,-1,2,chrXIII
426711,429627,2916,-1,2,chrXIII
422502,424728,2226,-1,2,chrXIII
407034,407541,507,-1,2,chrXIII
406665,407016,351,-1,2,chrXIII
404322,405573,1251,-1,2,chrXIII
386100,387021,921,-1,2,chrXIII
383460,384018,558,-1,2,chrXIII
373056,376524,3468,-1,2,chrXIII
363363,366705,3342,-1,2,chrXIII
359244,359556,312,-1,2,chrXIII
356718,357045,327,-1,2,chrXIII
339417,340722,1305,-1,2,chrXIII
332211,334743,2532,-1,2,chrXIII
328659,330231,1572,-1,2,chrXIII
326310,326742,432,-1,2,chrXIII
317658,318099,441,-1,2,chrXIII
283080,283548,468,-1,2,chrXIII
277560,279681,2121,-1,2,chrXIII
251838,252990,1152,-1,2,chrXIII
250674,251001,327,-1,2,chrXIII
246894,247428,534,-1,2,chrXIII
239457,241536,2079,-1,2,chrXIII
212514,214029,1515,-1,2,chrXIII
209427,209826,399,-1,2,chrXIII
206427,208860,2433,-1,2,chrXIII
174219,178305,4086,-1,2,chrXIII
147504,148683,1179,-1,2,chrXIII
139062,139917,855,-1,2,chrXIII
112512,115347,2835,-1,2,chrXIII
95790,97371,1581,-1,2,chrXIII
85986,86739,753,-1,2,chrXIII
85041,85353,312,-1,2,chrXIII
82218,82620,402,-1,2,chrXIII
81480,82113,633,-1,2,chrXIII
74397,77040,2643,-1,2,chrXIII
69408,69726,318,-1,2,chrXIII
58938,62322,3384,-1,2,chrXIII
42042,43575,1533,-1,2,chrXIII
26037,26418,381,-1,2,chrXIII
24036,25800,1764,-1,2,chrXIII
22047,23433,1386,-1,2,chrXIII
20760,21699,939,-1,2,chrXIII
19059,20535,1476,-1,2,chrXIII
1548,2124,576,-1,2,chrXIII
11451,12129,678,1,0,chrXIV
13266,14163,897,1,0,chrXIV
34695,37422,2727,1,0,chrXIV
61509,61857,348,1,0,chrXIV
66516,68445,1929,1,0,chrXIV
72216,72594,378,1,0,chrXIV
76272,76587,315,1,0,chrXIV
86217,87240,1023,1,0,chrXIV
110916,112902,1986,1,0,chrXIV
117348,118809,1461,1,0,chrXIV
138549,140385,1836,1,0,chrXIV
140877,144078,3201,1,0,chrXIV
164502,167097,2595,1,0,chrXIV
182874,185178,2304,1,0,chrXIV
200481,201933,1452,1,0,chrXIV
220644,221421,777,1,0,chrXIV
240330,241311,981,1,0,chrXIV
244467,245430,963,1,0,chrXIV
245616,246216,600,1,0,chrXIV
254676,255051,375,1,0,chrXIV
276501,279897,3396,1,0,chrXIV
280431,281505,1074,1,0,chrXIV
284259,285888,1629,1,0,chrXIV
289497,291876,2379,1,0,chrXIV
302679,303402,723,1,0,chrXIV
308073,308646,573,1,0,chrXIV
310635,315882,5247,1,0,chrXIV
351714,352017,303,1,0,chrXIV
359595,360639,1044,1,0,chrXIV
393828,394167,339,1,0,chrXIV
412770,413199,429,1,0,chrXIV
427734,429753,2019,1,0,chrXIV
430086,434493,4407,1,0,chrXIV
446370,446781,411,1,0,chrXIV
450870,452073,1203,1,0,chrXIV
456564,457143,579,1,0,chrXIV
467130,469623,2493,1,0,chrXIV
483555,485310,1755,1,0,chrXIV
488385,490116,1731,1,0,chrXIV
499680,500256,576,1,0,chrXIV
516402,516735,333,1,0,chrXIV
517248,517842,594,1,0,chrXIV
521256,524706,3450,1,0,chrXIV
529941,531411,1470,1,0,chrXIV
545400,545877,477,1,0,chrXIV
557019,557658,639,1,0,chrXIV
576726,577038,312,1,0,chrXIV
579579,581616,2037,1,0,chrXIV
581919,583374,1455,1,0,chrXIV
593226,595347,2121,1,0,chrXIV
606318,609453,3135,1,0,chrXIV
614820,616083,1263,1,0,chrXIV
623331,624621,1290,1,0,chrXIV
640395,642381,1986,1,0,chrXIV
643743,644193,450,1,0,chrXIV
652464,653103,639,1,0,chrXIV
664269,664944,675,1,0,chrXIV
668376,669591,1215,1,0,chrXIV
672408,672969,561,1,0,chrXIV
674922,675876,954,1,0,chrXIV
676176,677103,927,1,0,chrXIV
678798,680454,1656,1,0,chrXIV
680904,681273,369,1,0,chrXIV
703698,705876,2178,1,0,chrXIV
707787,708195,408,1,0,chrXIV
708522,711204,2682,1,0,chrXIV
719679,720018,339,1,0,chrXIV
739950,742110,2160,1,0,chrXIV
772656,774351,1695,1,0,chrXIV
781917,782280,363,1,0,chrXIV
733,1216,483,1,1,chrXIV
1516,2092,576,1,1,chrXIV
4249,4600,351,1,1,chrXIV
8329,9475,1146,1,1,chrXIV
37699,38554,855,1,1,chrXIV
38641,39082,441,1,1,chrXIV
40618,42016,1398,1,1,chrXIV
44446,45214,768,1,1,chrXIV
65743,66052,309,1,1,chrXIV
68914,71443,2529,1,1,chrXIV
76945,78520,1575,1,1,chrXIV
91993,94801,2808,1,1,chrXIV
96172,96544,372,1,1,chrXIV
107686,108274,588,1,1,chrXIV
108466,108928,462,1,1,chrXIV
136348,136720,372,1,1,chrXIV
137698,138094,396,1,1,chrXIV
144244,144664,420,1,1,chrXIV
170017,171286,1269,1,1,chrXIV
185578,186349,771,1,1,chrXIV
188050,190957,2907,1,1,chrXIV
191323,196102,4779,1,1,chrXIV
206929,209854,2925,1,1,chrXIV
210232,211513,1281,1,1,chrXIV
211921,214600,2679,1,1,chrXIV
222238,222649,411,1,1,chrXIV
229093,229714,621,1,1,chrXIV
234412,235714,1302,1,1,chrXIV
238237,240001,1764,1,1,chrXIV
250930,251743,813,1,1,chrXIV
252058,253900,1842,1,1,chrXIV
255352,256630,1278,1,1,chrXIV
282394,283009,615,1,1,chrXIV
332596,334867,2271,1,1,chrXIV
336544,337609,1065,1,1,chrXIV
340351,340858,507,1,1,chrXIV
346312,347542,1230,1,1,chrXIV
378766,379225,459,1,1,chrXIV
383986,386848,2862,1,1,chrXIV
387226,389767,2541,1,1,chrXIV
394684,397678,2994,1,1,chrXIV
406357,408022,1665,1,1,chrXIV
408340,409909,1569,1,1,chrXIV
413638,414943,1305,1,1,chrXIV
415948,416281,333,1,1,chrXIV
418963,419509,546,1,1,chrXIV
420097,420778,681,1,1,chrXIV
423466,423805,339,1,1,chrXIV
434998,437140,2142,1,1,chrXIV
447610,449374,1764,1,1,chrXIV
452407,456130,3723,1,1,chrXIV
466333,466642,309,1,1,chrXIV
471376,472861,1485,1,1,chrXIV
479767,480991,1224,1,1,chrXIV
481390,482977,1587,1,1,chrXIV
484249,484825,576,1,1,chrXIV
501514,502777,1263,1,1,chrXIV
507757,508702,945,1,1,chrXIV
522508,522820,312,1,1,chrXIV
531724,532186,462,1,1,chrXIV
541240,541645,405,1,1,chrXIV
542962,544978,2016,1,1,chrXIV
558307,558661,354,1,1,chrXIV
559813,560479,666,1,1,chrXIV
572998,573853,855,1,1,chrXIV
610054,611665,1611,1,1,chrXIV
636985,638854,1869,1,1,chrXIV
647431,648937,1506,1,1,chrXIV
653386,654541,1155,1,1,chrXIV
665338,667267,1929,1,1,chrXIV
670417,672118,1701,1,1,chrXIV
687634,689998,2364,1,1,chrXIV
706138,707608,1470,1,1,chrXIV
734290,735733,1443,1,1,chrXIV
770737,771088,351,1,1,chrXIV
1502,2009,507,1,2,chrXIV
2378,2714,336,1,2,chrXIV
14831,15854,1023,1,2,chrXIV
24047,27173,3126,1,2,chrXIV
31049,31445,396,1,2,chrXIV
31943,33188,1245,1,2,chrXIV
49448,49763,315,1,2,chrXIV
52544,53924,1380,1,2,chrXIV
58154,58808,654,1,2,chrXIV
60296,61550,1254,1,2,chrXIV
80639,82541,1902,1,2,chrXIV
82805,84017,1212,1,2,chrXIV
87896,88736,840,1,2,chrXIV
90302,91424,1122,1,2,chrXIV
95222,96080,858,1,2,chrXIV
113270,116453,3183,1,2,chrXIV
119267,120998,1731,1,2,chrXIV
122882,126599,3717,1,2,chrXIV
135770,136070,300,1,2,chrXIV
148211,154880,6669,1,2,chrXIV
155099,156539,1440,1,2,chrXIV
175409,179348,3939,1,2,chrXIV
202427,204872,2445,1,2,chrXIV
205187,206567,1380,1,2,chrXIV
214922,215801,879,1,2,chrXIV
227333,228854,1521,1,2,chrXIV
241688,244172,2484,1,2,chrXIV
247460,249809,2349,1,2,chrXIV
254417,255017,600,1,2,chrXIV
259568,260456,888,1,2,chrXIV
274367,276044,1677,1,2,chrXIV
282545,282950,405,1,2,chrXIV
286307,287609,1302,1,2,chrXIV
287771,289067,1296,1,2,chrXIV
298334,299558,1224,1,2,chrXIV
315977,316373,396,1,2,chrXIV
323831,325052,1221,1,2,chrXIV
339611,340208,597,1,2,chrXIV
342515,343340,825,1,2,chrXIV
343856,344306,450,1,2,chrXIV
349250,349658,408,1,2,chrXIV
357452,358952,1500,1,2,chrXIV
366740,368321,1581,1,2,chrXIV
370367,371645,1278,1,2,chrXIV
375320,378491,3171,1,2,chrXIV
381479,382202,723,1,2,chrXIV
382358,383663,1305,1,2,chrXIV
391811,392147,336,1,2,chrXIV
392891,394370,1479,1,2,chrXIV
401039,402521,1482,1,2,chrXIV
421304,421685,381,1,2,chrXIV
424154,424583,429,1,2,chrXIV
437612,438317,705,1,2,chrXIV
449867,450530,663,1,2,chrXIV
457703,461990,4287,1,2,chrXIV
462410,465947,3537,1,2,chrXIV
473297,476012,2715,1,2,chrXIV
485606,486479,873,1,2,chrXIV
490316,491240,924,1,2,chrXIV
491522,492971,1449,1,2,chrXIV
503723,505484,1761,1,2,chrXIV
510539,512396,1857,1,2,chrXIV
519455,520778,1323,1,2,chrXIV
526085,529583,3498,1,2,chrXIV
532658,533870,1212,1,2,chrXIV
538172,539819,1647,1,2,chrXIV
542303,542822,519,1,2,chrXIV
544226,544544,318,1,2,chrXIV
548099,549290,1191,1,2,chrXIV
553379,554750,1371,1,2,chrXIV
555047,556832,1785,1,2,chrXIV
570476,572315,1839,1,2,chrXIV
574505,575351,846,1,2,chrXIV
578678,578996,318,1,2,chrXIV
602906,604268,1362,1,2,chrXIV
613634,614360,726,1,2,chrXIV
620066,620978,912,1,2,chrXIV
627455,628616,1161,1,2,chrXIV
635942,636383,441,1,2,chrXIV
642689,643439,750,1,2,chrXIV
649298,649844,546,1,2,chrXIV
662912,663581,669,1,2,chrXIV
673820,674123,303,1,2,chrXIV
686009,687116,1107,1,2,chrXIV
690320,691286,966,1,2,chrXIV
695594,697484,1890,1,2,chrXIV
699689,700460,771,1,2,chrXIV
701237,701666,429,1,2,chrXIV
701894,703085,1191,1,2,chrXIV
711629,712811,1182,1,2,chrXIV
717206,717530,324,1,2,chrXIV
736802,738545,1743,1,2,chrXIV
746942,748766,1824,1,2,chrXIV
765374,769376,4002,1,2,chrXIV
779915,781040,1125,1,2,chrXIV
777601,778738,1137,-1,0,chrXIV
761122,762592,1470,-1,0,chrXIV
760066,760885,819,-1,0,chrXIV
753724,755035,1311,-1,0,chrXIV
750349,753700,3351,-1,0,chrXIV
731617,733303,1686,-1,0,chrXIV
728425,730186,1761,-1,0,chrXIV
723355,724306,951,-1,0,chrXIV
722293,723112,819,-1,0,chrXIV
716779,718327,1548,-1,0,chrXIV
706186,706585,399,-1,0,chrXIV
700540,701659,1119,-1,0,chrXIV
694360,694822,462,-1,0,chrXIV
673273,674689,1416,-1,0,chrXIV
649027,651712,2685,-1,0,chrXIV
639181,640114,933,-1,0,chrXIV
636046,636373,327,-1,0,chrXIV
633007,633856,849,-1,0,chrXIV
626173,627142,969,-1,0,chrXIV
618994,619399,405,-1,0,chrXIV
616210,618241,2031,-1,0,chrXIV
602137,602476,339,-1,0,chrXIV
599935,601774,1839,-1,0,chrXIV
598375,599230,855,-1,0,chrXIV
588262,591160,2898,-1,0,chrXIV
577204,578773,1569,-1,0,chrXIV
566383,567820,1437,-1,0,chrXIV
555148,555583,435,-1,0,chrXIV
517993,518845,852,-1,0,chrXIV
505867,507097,1230,-1,0,chrXIV
495700,498289,2589,-1,0,chrXIV
492502,492868,366,-1,0,chrXIV
485968,486448,480,-1,0,chrXIV
447754,448066,312,-1,0,chrXIV
424894,426754,1860,-1,0,chrXIV
420943,424495,3552,-1,0,chrXIV
401032,401518,486,-1,0,chrXIV
398683,400537,1854,-1,0,chrXIV
393466,393820,354,-1,0,chrXIV
390145,392167,2022,-1,0,chrXIV
374170,374692,522,-1,0,chrXIV
371881,372226,345,-1,0,chrXIV
360916,361486,570,-1,0,chrXIV
352819,355042,2223,-1,0,chrXIV
349906,350671,765,-1,0,chrXIV
349366,349756,390,-1,0,chrXIV
341068,341968,900,-1,0,chrXIV
326740,330073,3333,-1,0,chrXIV
325264,326320,1056,-1,0,chrXIV
316168,317671,1503,-1,0,chrXIV
315628,315997,369,-1,0,chrXIV
308956,310057,1101,-1,0,chrXIV
303685,304615,930,-1,0,chrXIV
299653,300649,996,-1,0,chrXIV
292192,292669,477,-1,0,chrXIV
282508,282871,363,-1,0,chrXIV
271522,272308,786,-1,0,chrXIV
270274,271171,897,-1,0,chrXIV
267607,269593,1986,-1,0,chrXIV
264925,266530,1605,-1,0,chrXIV
260626,263203,2577,-1,0,chrXIV
259438,260050,612,-1,0,chrXIV
258154,258577,423,-1,0,chrXIV
231067,233695,2628,-1,0,chrXIV
219136,220201,1065,-1,0,chrXIV
217522,218662,1140,-1,0,chrXIV
215986,217042,1056,-1,0,chrXIV
205987,206323,336,-1,0,chrXIV
203917,204457,540,-1,0,chrXIV
202627,202945,318,-1,0,chrXIV
181360,182608,1248,-1,0,chrXIV
160630,164320,3690,-1,0,chrXIV
151255,151630,375,-1,0,chrXIV
131404,131716,312,-1,0,chrXIV
121117,122170,1053,-1,0,chrXIV
117832,118159,327,-1,0,chrXIV
100909,102232,1323,-1,0,chrXIV
81607,81937,330,-1,0,chrXIV
78658,80260,1602,-1,0,chrXIV
61957,62260,303,-1,0,chrXIV
58897,59791,894,-1,0,chrXIV
54121,55897,1776,-1,0,chrXIV
49396,51688,2292,-1,0,chrXIV
45307,48022,2715,-1,0,chrXIV
42070,43177,1107,-1,0,chrXIV
38830,39130,300,-1,0,chrXIV
33820,34126,306,-1,0,chrXIV
28738,31378,2640,-1,0,chrXIV
19540,22633,3093,-1,0,chrXIV
16117,17248,1131,-1,0,chrXIV
370,5758,5388,-1,0,chrXIV
770439,771468,1029,-1,1,chrXIV
755745,759099,3354,-1,1,chrXIV
721119,721506,387,-1,1,chrXIV
713022,713655,633,-1,1,chrXIV
693018,694047,1029,-1,1,chrXIV
670761,671307,546,-1,1,chrXIV
665517,665967,450,-1,1,chrXIV
654672,661374,6702,-1,1,chrXIV
644319,646950,2631,-1,1,chrXIV
636930,637335,405,-1,1,chrXIV
621312,622428,1116,-1,1,chrXIV
611835,613170,1335,-1,1,chrXIV
609132,609510,378,-1,1,chrXIV
591426,592899,1473,-1,1,chrXIV
587106,587847,741,-1,1,chrXIV
584319,585291,972,-1,1,chrXIV
568521,569691,1170,-1,1,chrXIV
562386,566427,4041,-1,1,chrXIV
557919,559002,1083,-1,1,chrXIV
539910,541881,1971,-1,1,chrXIV
534078,534549,471,-1,1,chrXIV
518793,519156,363,-1,1,chrXIV
512667,514935,2268,-1,1,chrXIV
507744,508044,300,-1,1,chrXIV
496071,496380,309,-1,1,chrXIV
486765,488124,1359,-1,1,chrXIV
476931,478032,1101,-1,1,chrXIV
476187,476619,432,-1,1,chrXIV
470052,471102,1050,-1,1,chrXIV
461007,461316,309,-1,1,chrXIV
452967,453627,660,-1,1,chrXIV
435609,435930,321,-1,1,chrXIV
420453,420765,312,-1,1,chrXIV
419013,419826,813,-1,1,chrXIV
417825,418488,663,-1,1,chrXIV
412683,413055,372,-1,1,chrXIV
410118,412053,1935,-1,1,chrXIV
402651,405564,2913,-1,1,chrXIV
398022,398370,348,-1,1,chrXIV
385407,385833,426,-1,1,chrXIV
379557,380604,1047,-1,1,chrXIV
378831,379182,351,-1,1,chrXIV
372450,373581,1131,-1,1,chrXIV
356793,357186,393,-1,1,chrXIV
343635,345276,1641,-1,1,chrXIV
322218,323565,1347,-1,1,chrXIV
295959,297627,1668,-1,1,chrXIV
293136,295509,2373,-1,1,chrXIV
272709,273615,906,-1,1,chrXIV
263712,264453,741,-1,1,chrXIV
252126,252495,369,-1,1,chrXIV
246459,247104,645,-1,1,chrXIV
235995,237663,1668,-1,1,chrXIV
229326,229650,324,-1,1,chrXIV
222723,224469,1746,-1,1,chrXIV
209547,209979,432,-1,1,chrXIV
198501,199977,1476,-1,1,chrXIV
196425,197943,1518,-1,1,chrXIV
186345,186885,540,-1,1,chrXIV
172587,174315,1728,-1,1,chrXIV
168042,169248,1206,-1,1,chrXIV
167328,167790,462,-1,1,chrXIV
156858,157455,597,-1,1,chrXIV
146895,147840,945,-1,1,chrXIV
144279,145125,846,-1,1,chrXIV
135939,137661,1722,-1,1,chrXIV
126804,129084,2280,-1,1,chrXIV
105183,106695,1512,-1,1,chrXIV
96963,100431,3468,-1,1,chrXIV
93072,93378,306,-1,1,chrXIV
84168,85815,1647,-1,1,chrXIV
56445,57573,1128,-1,1,chrXIV
51906,52524,618,-1,1,chrXIV
43323,44280,957,-1,1,chrXIV
41049,41379,330,-1,1,chrXIV
38706,40329,1623,-1,1,chrXIV
27336,28347,1011,-1,1,chrXIV
22833,23274,441,-1,1,chrXIV
18000,19302,1302,-1,1,chrXIV
12207,12876,669,-1,1,chrXIV
1455,2031,576,-1,1,chrXIV
774791,776300,1509,-1,2,chrXIV
749135,750008,873,-1,2,chrXIV
744359,745343,984,-1,2,chrXIV
742880,743540,660,-1,2,chrXIV
741158,741488,330,-1,2,chrXIV
733355,734069,714,-1,2,chrXIV
719345,720647,1302,-1,2,chrXIV
714047,715388,1341,-1,2,chrXIV
707765,708101,336,-1,2,chrXIV
705503,705845,342,-1,2,chrXIV
697613,699431,1818,-1,2,chrXIV
680693,685433,4740,-1,2,chrXIV
677198,678488,1290,-1,2,chrXIV
672701,673061,360,-1,2,chrXIV
669773,670193,420,-1,2,chrXIV
667409,668222,813,-1,2,chrXIV
664301,664691,390,-1,2,chrXIV
652202,652502,300,-1,2,chrXIV
634343,635297,954,-1,2,chrXIV
629621,631061,1440,-1,2,chrXIV
624974,625829,855,-1,2,chrXIV
623729,624095,366,-1,2,chrXIV
618506,619565,1059,-1,2,chrXIV
606998,607451,453,-1,2,chrXIV
595622,597539,1917,-1,2,chrXIV
575639,576050,411,-1,2,chrXIV
549467,551987,2520,-1,2,chrXIV
545588,545909,321,-1,2,chrXIV
535280,537911,2631,-1,2,chrXIV
515762,516713,951,-1,2,chrXIV
508775,510212,1437,-1,2,chrXIV
493955,494297,342,-1,2,chrXIV
478565,479165,600,-1,2,chrXIV
456692,457169,477,-1,2,chrXIV
444911,446840,1929,-1,2,chrXIV
441365,442358,993,-1,2,chrXIV
439601,440570,969,-1,2,chrXIV
438566,439283,717,-1,2,chrXIV
416939,417302,363,-1,2,chrXIV
368594,370055,1461,-1,2,chrXIV
360923,365717,4794,-1,2,chrXIV
347765,348521,756,-1,2,chrXIV
345668,346058,390,-1,2,chrXIV
343646,344141,495,-1,2,chrXIV
338477,339347,870,-1,2,chrXIV
319415,321359,1944,-1,2,chrXIV
318029,318809,780,-1,2,chrXIV
314249,314561,312,-1,2,chrXIV
313862,314168,306,-1,2,chrXIV
307400,308612,1212,-1,2,chrXIV
305069,306980,1911,-1,2,chrXIV
300665,301103,438,-1,2,chrXIV
294425,294782,357,-1,2,chrXIV
292556,292883,327,-1,2,chrXIV
281003,281303,300,-1,2,chrXIV
266513,266816,303,-1,2,chrXIV
258374,259277,903,-1,2,chrXIV
256787,258155,1368,-1,2,chrXIV
242561,242867,306,-1,2,chrXIV
224795,227099,2304,-1,2,chrXIV
220658,222431,1773,-1,2,chrXIV
187169,187496,327,-1,2,chrXIV
179393,181022,1629,-1,2,chrXIV
171440,172286,846,-1,2,chrXIV
158108,160373,2265,-1,2,chrXIV
145562,146615,1053,-1,2,chrXIV
129521,135383,5862,-1,2,chrXIV
118430,118826,396,-1,2,chrXIV
109094,110411,1317,-1,2,chrXIV
103133,104102,969,-1,2,chrXIV
98849,99161,312,-1,2,chrXIV
71672,76583,4911,-1,2,chrXIV
33293,34235,942,-1,2,chrXIV
6174,8115,1941,1,0,chrXV
25272,26976,1704,1,0,chrXV
44937,45633,696,1,0,chrXV
53097,54552,1455,1,0,chrXV
55557,56280,723,1,0,chrXV
56451,58539,2088,1,0,chrXV
58758,60030,1272,1,0,chrXV
77559,78114,555,1,0,chrXV
87843,89448,1605,1,0,chrXV
104325,106293,1968,1,0,chrXV
112101,113130,1029,1,0,chrXV
115005,115356,351,1,0,chrXV
117999,119322,1323,1,0,chrXV
147381,150276,2895,1,0,chrXV
168726,169974,1248,1,0,chrXV
171069,180309,9240,1,0,chrXV
181056,181455,399,1,0,chrXV
187023,189414,2391,1,0,chrXV
196506,196995,489,1,0,chrXV
217125,218448,1323,1,0,chrXV
219210,220473,1263,1,0,chrXV
234939,238185,3246,1,0,chrXV
247149,248301,1152,1,0,chrXV
255336,256101,765,1,0,chrXV
265428,266169,741,1,0,chrXV
274956,276939,1983,1,0,chrXV
278055,280086,2031,1,0,chrXV
288897,290553,1656,1,0,chrXV
310311,310935,624,1,0,chrXV
325248,326130,882,1,0,chrXV
333591,334356,765,1,0,chrXV
344334,345798,1464,1,0,chrXV
364368,366882,2514,1,0,chrXV
400347,401214,867,1,0,chrXV
428928,429240,312,1,0,chrXV
429477,429912,435,1,0,chrXV
447438,448368,930,1,0,chrXV
479532,480420,888,1,0,chrXV
495126,496968,1842,1,0,chrXV
502794,503346,552,1,0,chrXV
511824,513006,1182,1,0,chrXV
517641,518490,849,1,0,chrXV
519120,519972,852,1,0,chrXV
521352,522282,930,1,0,chrXV
523026,524841,1815,1,0,chrXV
531507,533793,2286,1,0,chrXV
545028,546333,1305,1,0,chrXV
573174,574830,1656,1,0,chrXV
575097,577626,2529,1,0,chrXV
586980,589281,2301,1,0,chrXV
606513,608475,1962,1,0,chrXV
619839,624375,4536,1,0,chrXV
632163,633120,957,1,0,chrXV
644565,646896,2331,1,0,chrXV
649302,651732,2430,1,0,chrXV
658746,659601,855,1,0,chrXV
662400,663582,1182,1,0,chrXV
674778,675150,372,1,0,chrXV
679356,680544,1188,1,0,chrXV
710445,711576,1131,1,0,chrXV
718782,719160,378,1,0,chrXV
720180,720510,330,1,0,chrXV
722910,724725,1815,1,0,chrXV
740706,741180,474,1,0,chrXV
747861,748209,348,1,0,chrXV
748275,748644,369,1,0,chrXV
752589,752895,306,1,0,chrXV
761391,761721,330,1,0,chrXV
768408,769812,1404,1,0,chrXV
770799,772113,1314,1,0,chrXV
775845,778248,2403,1,0,chrXV
785169,785655,486,1,0,chrXV
785655,786744,1089,1,0,chrXV
795105,795405,300,1,0,chrXV
798012,798315,303,1,0,chrXV
807270,808107,837,1,0,chrXV
818865,820158,1293,1,0,chrXV
821022,822294,1272,1,0,chrXV
832812,834195,1383,1,0,chrXV
841332,841818,486,1,0,chrXV
846999,847320,321,1,0,chrXV
847452,848145,693,1,0,chrXV
853356,854112,756,1,0,chrXV
855801,856185,384,1,0,chrXV
861174,865593,4419,1,0,chrXV
867399,867852,453,1,0,chrXV
870201,874071,3870,1,0,chrXV
875598,877038,1440,1,0,chrXV
895308,895953,645,1,0,chrXV
903042,903372,330,1,0,chrXV
909342,911445,2103,1,0,chrXV
916029,918291,2262,1,0,chrXV
923763,924156,393,1,0,chrXV
924576,925050,474,1,0,chrXV
943107,943458,351,1,0,chrXV
944595,946008,1413,1,0,chrXV
971850,975891,4041,1,0,chrXV
997212,998244,1032,1,0,chrXV
1007220,1009116,1896,1,0,chrXV
1010160,1010889,729,1,0,chrXV
1012002,1012392,390,1,0,chrXV
1026006,1026609,603,1,0,chrXV
1036833,1039389,2556,1,0,chrXV
1039839,1041399,1560,1,0,chrXV
1043190,1043559,369,1,0,chrXV
1055544,1057680,2136,1,0,chrXV
1065042,1065915,873,1,0,chrXV
1085472,1090863,5391,1,0,chrXV
34657,35407,750,1,1,chrXV
40747,42610,1863,1,1,chrXV
43693,44722,1029,1,1,chrXV
49894,50260,366,1,1,chrXV
65620,67114,1494,1,1,chrXV
70324,70690,366,1,1,chrXV
71299,72715,1416,1,1,chrXV
73030,73357,327,1,1,chrXV
83833,85264,1431,1,1,chrXV
90730,91102,372,1,1,chrXV
99808,100957,1149,1,1,chrXV
104587,104920,333,1,1,chrXV
110296,110638,342,1,1,chrXV
119800,123268,3468,1,1,chrXV
123991,125830,1839,1,1,chrXV
145333,147163,1830,1,1,chrXV
162355,165331,2976,1,1,chrXV
181681,185212,3531,1,1,chrXV
223267,224179,912,1,1,chrXV
225016,225325,309,1,1,chrXV
228613,229834,1221,1,1,chrXV
236107,236452,345,1,1,chrXV
238618,240094,1476,1,1,chrXV
243496,246802,3306,1,1,chrXV
254296,254617,321,1,1,chrXV
256744,259030,2286,1,1,chrXV
268186,269641,1455,1,1,chrXV
270799,271147,348,1,1,chrXV
286171,287950,1779,1,1,chrXV
292528,294673,2145,1,1,chrXV
299692,300067,375,1,1,chrXV
329416,331051,1635,1,1,chrXV
346321,346726,405,1,1,chrXV
349678,353863,4185,1,1,chrXV
356542,356956,414,1,1,chrXV
357673,359947,2274,1,1,chrXV
359992,360352,360,1,1,chrXV
361411,363814,2403,1,1,chrXV
379780,380806,1026,1,1,chrXV
381052,382822,1770,1,1,chrXV
386824,388684,1860,1,1,chrXV
398869,399226,357,1,1,chrXV
399253,399694,441,1,1,chrXV
401440,402655,1215,1,1,chrXV
408424,409660,1236,1,1,chrXV
410869,412330,1461,1,1,chrXV
416761,417088,327,1,1,chrXV
420553,420880,327,1,1,chrXV
427816,428158,342,1,1,chrXV
444685,445849,1164,1,1,chrXV
447658,447976,318,1,1,chrXV
464770,466543,1773,1,1,chrXV
468211,469252,1041,1,1,chrXV
471898,472597,699,1,1,chrXV
480586,481750,1164,1,1,chrXV
482032,483085,1053,1,1,chrXV
493264,494470,1206,1,1,chrXV
518194,518521,327,1,1,chrXV
525277,528601,3324,1,1,chrXV
528940,530248,1308,1,1,chrXV
530428,531127,699,1,1,chrXV
546856,548560,1704,1,1,chrXV
551113,552052,939,1,1,chrXV
561169,564193,3024,1,1,chrXV
578563,579793,1230,1,1,chrXV
580249,581359,1110,1,1,chrXV
593056,594046,990,1,1,chrXV
595111,596434,1323,1,1,chrXV
605452,605824,372,1,1,chrXV
605872,606178,306,1,1,chrXV
611998,612490,492,1,1,chrXV
633838,636757,2919,1,1,chrXV
671875,672322,447,1,1,chrXV
678871,679261,390,1,1,chrXV
683110,683545,435,1,1,chrXV
689623,689974,351,1,1,chrXV
690694,692032,1338,1,1,chrXV
717022,718384,1362,1,1,chrXV
721945,722608,663,1,1,chrXV
733924,736177,2253,1,1,chrXV
742909,744181,1272,1,1,chrXV
758329,759253,924,1,1,chrXV
759781,760660,879,1,1,chrXV
772600,774127,1527,1,1,chrXV
779869,780184,315,1,1,chrXV
781993,783298,1305,1,1,chrXV
783667,784588,921,1,1,chrXV
786994,788641,1647,1,1,chrXV
804376,804907,531,1,1,chrXV
812875,813331,456,1,1,chrXV
817291,818335,1044,1,1,chrXV
820453,820774,321,1,1,chrXV
826384,827869,1485,1,1,chrXV
837673,838960,1287,1,1,chrXV
849634,850054,420,1,1,chrXV
850279,850729,450,1,1,chrXV
868339,868951,612,1,1,chrXV
878434,880675,2241,1,1,chrXV
882898,884134,1236,1,1,chrXV
889021,889750,729,1,1,chrXV
904759,905800,1041,1,1,chrXV
922408,922807,399,1,1,chrXV
925720,930445,4725,1,1,chrXV
937291,937786,495,1,1,chrXV
954343,956623,2280,1,1,chrXV
987283,987592,309,1,1,chrXV
989788,992833,3045,1,1,chrXV
1005136,1006705,1569,1,1,chrXV
1016722,1017043,321,1,1,chrXV
1023370,1023739,369,1,1,chrXV
1028215,1028515,300,1,1,chrXV
1037323,1037704,381,1,1,chrXV
1061563,1063648,2085,1,1,chrXV
1079281,1079725,444,1,1,chrXV
1089199,1089775,576,1,1,chrXV
9596,10106,510,1,2,chrXV
10118,10766,648,1,2,chrXV
14312,14654,342,1,2,chrXV
31166,31532,366,1,2,chrXV
48737,49448,711,1,2,chrXV
63155,63668,513,1,2,chrXV
74399,76979,2580,1,2,chrXV
97550,99488,1938,1,2,chrXV
101474,103229,1755,1,2,chrXV
106709,108188,1479,1,2,chrXV
109175,109889,714,1,2,chrXV
113225,113579,354,1,2,chrXV
128048,128348,300,1,2,chrXV
129236,132482,3246,1,2,chrXV
134165,134621,456,1,2,chrXV
142814,143696,882,1,2,chrXV
144203,145130,927,1,2,chrXV
162749,163070,321,1,2,chrXV
165713,166952,1239,1,2,chrXV
194969,196337,1368,1,2,chrXV
198941,200297,1356,1,2,chrXV
212243,213734,1491,1,2,chrXV
220766,222902,2136,1,2,chrXV
230084,231272,1188,1,2,chrXV
249824,250916,1092,1,2,chrXV
253121,253589,468,1,2,chrXV
259922,263204,3282,1,2,chrXV
263474,265085,1611,1,2,chrXV
266636,267026,390,1,2,chrXV
269159,269519,360,1,2,chrXV
277085,277604,519,1,2,chrXV
297077,298838,1761,1,2,chrXV
305348,307409,2061,1,2,chrXV
307937,309041,1104,1,2,chrXV
316937,321548,4611,1,2,chrXV
326831,329033,2202,1,2,chrXV
331454,332891,1437,1,2,chrXV
356750,357221,471,1,2,chrXV
368126,370319,2193,1,2,chrXV
377846,378170,324,1,2,chrXV
378218,379562,1344,1,2,chrXV
384599,384935,336,1,2,chrXV
405767,406544,777,1,2,chrXV
407063,407921,858,1,2,chrXV
413006,413480,474,1,2,chrXV
432185,433373,1188,1,2,chrXV
441533,442553,1020,1,2,chrXV
449435,451325,1890,1,2,chrXV
453767,455795,2028,1,2,chrXV
461501,461816,315,1,2,chrXV
472724,473369,645,1,2,chrXV
474551,476792,2241,1,2,chrXV
487706,489734,2028,1,2,chrXV
503615,503948,333,1,2,chrXV
515243,516173,930,1,2,chrXV
516422,516773,351,1,2,chrXV
534074,536819,2745,1,2,chrXV
537569,538454,885,1,2,chrXV
596912,600380,3468,1,2,chrXV
624728,626492,1764,1,2,chrXV
642740,643307,567,1,2,chrXV
651857,652163,306,1,2,chrXV
654209,656570,2361,1,2,chrXV
657131,658325,1194,1,2,chrXV
675938,677840,1902,1,2,chrXV
684029,685343,1314,1,2,chrXV
685766,689180,3414,1,2,chrXV
692474,697334,4860,1,2,chrXV
712031,712370,339,1,2,chrXV
712865,715331,2466,1,2,chrXV
720416,720815,399,1,2,chrXV
722564,722918,354,1,2,chrXV
727511,729644,2133,1,2,chrXV
749300,751886,2586,1,2,chrXV
755327,756125,798,1,2,chrXV
756863,757250,387,1,2,chrXV
762824,766565,3741,1,2,chrXV
774572,775259,687,1,2,chrXV
780905,781541,636,1,2,chrXV
784856,785696,840,1,2,chrXV
792530,793868,1338,1,2,chrXV
797675,798308,633,1,2,chrXV
803666,804203,537,1,2,chrXV
811007,811493,486,1,2,chrXV
811670,812324,654,1,2,chrXV
813983,815720,1737,1,2,chrXV
822821,823211,390,1,2,chrXV
831299,831599,300,1,2,chrXV
835634,835958,324,1,2,chrXV
842816,843644,828,1,2,chrXV
843803,844220,417,1,2,chrXV
848477,849209,732,1,2,chrXV
869207,869894,687,1,2,chrXV
880574,880883,309,1,2,chrXV
880964,882272,1308,1,2,chrXV
884513,887876,3363,1,2,chrXV
912821,913463,642,1,2,chrXV
931802,936497,4695,1,2,chrXV
943655,944357,702,1,2,chrXV
949772,953870,4098,1,2,chrXV
956897,957989,1092,1,2,chrXV
960986,965981,4995,1,2,chrXV
970577,971894,1317,1,2,chrXV
981827,984785,2958,1,2,chrXV
1011188,1012760,1572,1,2,chrXV
1025255,1025609,354,1,2,chrXV
1026842,1028048,1206,1,2,chrXV
1046225,1047803,1578,1,2,chrXV
1049510,1051058,1548,1,2,chrXV
1051289,1052930,1641,1,2,chrXV
1059530,1059992,462,1,2,chrXV
1066838,1068536,1698,1,2,chrXV
1074212,1076087,1875,1,2,chrXV
1076783,1077911,1128,1,2,chrXV
1080275,1081589,1314,1,2,chrXV
1082717,1083212,495,1,2,chrXV
1089221,1089728,507,-1,0,chrXV
1088516,1088852,336,-1,0,chrXV
1078544,1079258,714,-1,0,chrXV
1060475,1060961,486,-1,0,chrXV
1050725,1051064,339,-1,0,chrXV
1041677,1043042,1365,-1,0,chrXV
1040363,1040666,303,-1,0,chrXV
1037126,1037453,327,-1,0,chrXV
1029182,1030994,1812,-1,0,chrXV
1020221,1023212,2991,-1,0,chrXV
1013240,1014821,1581,-1,0,chrXV
1009223,1009712,489,-1,0,chrXV
984941,986462,1521,-1,0,chrXV
973769,974084,315,-1,0,chrXV
968147,968474,327,-1,0,chrXV
966665,967625,960,-1,0,chrXV
965411,965729,318,-1,0,chrXV
959201,960182,981,-1,0,chrXV
958361,958832,471,-1,0,chrXV
946232,949109,2877,-1,0,chrXV
944540,944957,417,-1,0,chrXV
939620,943463,3843,-1,0,chrXV
923231,925040,1809,-1,0,chrXV
918605,921062,2457,-1,0,chrXV
917489,917855,366,-1,0,chrXV
894623,896387,1764,-1,0,chrXV
892730,894092,1362,-1,0,chrXV
877229,877685,456,-1,0,chrXV
874742,875321,579,-1,0,chrXV
865652,866582,930,-1,0,chrXV
863312,863696,384,-1,0,chrXV
862820,863210,390,-1,0,chrXV
855146,860258,5112,-1,0,chrXV
844991,845792,801,-1,0,chrXV
841514,841823,309,-1,0,chrXV
825533,825932,399,-1,0,chrXV
822587,824867,2280,-1,0,chrXV
818756,819164,408,-1,0,chrXV
808253,810683,2430,-1,0,chrXV
805031,807023,1992,-1,0,chrXV
800969,802307,1338,-1,0,chrXV
795800,796793,993,-1,0,chrXV
794075,795332,1257,-1,0,chrXV
788741,789857,1116,-1,0,chrXV
766868,767777,909,-1,0,chrXV
752213,755009,2796,-1,0,chrXV
751475,751895,420,-1,0,chrXV
747524,748979,1455,-1,0,chrXV
745592,746303,711,-1,0,chrXV
738923,741632,2709,-1,0,chrXV
736436,737726,1290,-1,0,chrXV
730007,733457,3450,-1,0,chrXV
718652,720065,1413,-1,0,chrXV
715592,716837,1245,-1,0,chrXV
681443,682106,663,-1,0,chrXV
674351,675167,816,-1,0,chrXV
667859,670241,2382,-1,0,chrXV
636938,638558,1620,-1,0,chrXV
630965,631751,786,-1,0,chrXV
626627,627980,1353,-1,0,chrXV
608639,609197,558,-1,0,chrXV
601382,602342,960,-1,0,chrXV
586949,587342,393,-1,0,chrXV
566876,569558,2682,-1,0,chrXV
553175,554570,1395,-1,0,chrXV
545117,545420,303,-1,0,chrXV
539762,544145,4383,-1,0,chrXV
538658,539465,807,-1,0,chrXV
532250,532865,615,-1,0,chrXV
507947,511178,3231,-1,0,chrXV
496148,496541,393,-1,0,chrXV
483218,486779,3561,-1,0,chrXV
473474,474416,942,-1,0,chrXV
469376,471620,2244,-1,0,chrXV
459479,461276,1797,-1,0,chrXV
455906,457820,1914,-1,0,chrXV
446078,446738,660,-1,0,chrXV
442724,443531,807,-1,0,chrXV
438905,440258,1353,-1,0,chrXV
427832,429857,2025,-1,0,chrXV
414458,415907,1449,-1,0,chrXV
392576,392915,339,-1,0,chrXV
373709,375857,2148,-1,0,chrXV
372797,373439,642,-1,0,chrXV
370523,370844,321,-1,0,chrXV
337679,338621,942,-1,0,chrXV
334508,337343,2835,-1,0,chrXV
321857,322994,1137,-1,0,chrXV
315812,316175,363,-1,0,chrXV
309323,310139,816,-1,0,chrXV
303578,303983,405,-1,0,chrXV
301379,303035,1656,-1,0,chrXV
294776,296120,1344,-1,0,chrXV
280271,281498,1227,-1,0,chrXV
270632,271370,738,-1,0,chrXV
253148,253577,429,-1,0,chrXV
241613,242267,654,-1,0,chrXV
240203,240524,321,-1,0,chrXV
237881,238202,321,-1,0,chrXV
232445,233636,1191,-1,0,chrXV
217307,217646,339,-1,0,chrXV
214016,216137,2121,-1,0,chrXV
206102,207176,1074,-1,0,chrXV
197219,198725,1506,-1,0,chrXV
180557,181427,870,-1,0,chrXV
169001,169319,318,-1,0,chrXV
161672,162014,342,-1,0,chrXV
153911,154745,834,-1,0,chrXV
139226,141347,2121,-1,0,chrXV
136526,137825,1299,-1,0,chrXV
125996,126689,693,-1,0,chrXV
114137,115808,1671,-1,0,chrXV
108257,108896,639,-1,0,chrXV
103316,103925,609,-1,0,chrXV
57776,58112,336,-1,0,chrXV
55805,56120,315,-1,0,chrXV
38174,38567,393,-1,0,chrXV
37271,38066,795,-1,0,chrXV
36821,37154,333,-1,0,chrXV
19490,21311,1821,-1,0,chrXV
1646,2078,432,-1,0,chrXV
1034806,1036471,1665,-1,1,chrXV
1031488,1034182,2694,-1,1,chrXV
1023460,1025572,2112,-1,1,chrXV
1015360,1017652,2292,-1,1,chrXV
1001146,1003225,2079,-1,1,chrXV
998452,1000828,2376,-1,1,chrXV
995017,996511,1494,-1,1,chrXV
992863,994855,1992,-1,1,chrXV
981811,982162,351,-1,1,chrXV
964612,964936,324,-1,1,chrXV
943564,944122,558,-1,1,chrXV
936730,939349,2619,-1,1,chrXV
930733,931081,348,-1,1,chrXV
925978,926302,324,-1,1,chrXV
913618,915094,1476,-1,1,chrXV
906235,907555,1320,-1,1,chrXV
896824,898360,1536,-1,1,chrXV
850936,851839,903,-1,1,chrXV
846268,847129,861,-1,1,chrXV
843697,844630,933,-1,1,chrXV
839083,841069,1986,-1,1,chrXV
834451,836431,1980,-1,1,chrXV
831058,832042,984,-1,1,chrXV
822751,823189,438,-1,1,chrXV
815914,816931,1017,-1,1,chrXV
802549,803464,915,-1,1,chrXV
798673,800731,2058,-1,1,chrXV
792703,793042,339,-1,1,chrXV
790210,792241,2031,-1,1,chrXV
765898,766324,426,-1,1,chrXV
756475,757558,1083,-1,1,chrXV
750532,751000,468,-1,1,chrXV
749662,749962,300,-1,1,chrXV
725563,727234,1671,-1,1,chrXV
720469,721708,1239,-1,1,chrXV
713242,713584,342,-1,1,chrXV
711682,712543,861,-1,1,chrXV
708415,709852,1437,-1,1,chrXV
698767,700567,1800,-1,1,chrXV
693367,693703,336,-1,1,chrXV
652009,653884,1875,-1,1,chrXV
647125,648502,1377,-1,1,chrXV
643393,644332,939,-1,1,chrXV
639559,641992,2433,-1,1,chrXV
602716,605092,2376,-1,1,chrXV
584308,586324,2016,-1,1,chrXV
581812,583681,1869,-1,1,chrXV
564475,566191,1716,-1,1,chrXV
559960,560677,717,-1,1,chrXV
551797,552103,306,-1,1,chrXV
548791,550246,1455,-1,1,chrXV
536281,536599,318,-1,1,chrXV
516448,516850,402,-1,1,chrXV
508972,509314,342,-1,1,chrXV
506977,507505,528,-1,1,chrXV
503551,504328,777,-1,1,chrXV
491122,492841,1719,-1,1,chrXV
490195,490828,633,-1,1,chrXV
489415,489715,300,-1,1,chrXV
476938,479188,2250,-1,1,chrXV
453868,454213,345,-1,1,chrXV
445420,445816,396,-1,1,chrXV
444811,445279,468,-1,1,chrXV
440389,441163,774,-1,1,chrXV
433687,436345,2658,-1,1,chrXV
430246,431626,1380,-1,1,chrXV
427828,428137,309,-1,1,chrXV
402760,405388,2628,-1,1,chrXV
389770,391075,1305,-1,1,chrXV
369727,370027,300,-1,1,chrXV
360460,361084,624,-1,1,chrXV
323410,324394,984,-1,1,chrXV
311341,312367,1026,-1,1,chrXV
308308,308611,303,-1,1,chrXV
272002,273724,1722,-1,1,chrXV
266263,267529,1266,-1,1,chrXV
264178,264676,498,-1,1,chrXV
258802,259105,303,-1,1,chrXV
251266,252646,1380,-1,1,chrXV
224419,226075,1656,-1,1,chrXV
214024,214495,471,-1,1,chrXV
207391,210265,2874,-1,1,chrXV
204730,205885,1155,-1,1,chrXV
199831,200134,303,-1,1,chrXV
193831,194800,969,-1,1,chrXV
166288,166612,324,-1,1,chrXV
159547,160594,1047,-1,1,chrXV
150397,153490,3093,-1,1,chrXV
141583,142555,972,-1,1,chrXV
138106,139057,951,-1,1,chrXV
132724,135838,3114,-1,1,chrXV
132016,132508,492,-1,1,chrXV
116395,117454,1059,-1,1,chrXV
111430,111886,456,-1,1,chrXV
96607,96916,309,-1,1,chrXV
94855,96361,1506,-1,1,chrXV
61324,65350,4026,-1,1,chrXV
60382,61024,642,-1,1,chrXV
47932,48643,711,-1,1,chrXV
34765,35077,312,-1,1,chrXV
28702,31606,2904,-1,1,chrXV
11548,11911,363,-1,1,chrXV
1090014,1090497,483,-1,2,chrXV
1089138,1089714,576,-1,2,chrXV
1086630,1086981,351,-1,2,chrXV
1071792,1072923,1131,-1,2,chrXV
1069620,1070241,621,-1,2,chrXV
1060440,1061055,615,-1,2,chrXV
1055772,1056099,327,-1,2,chrXV
1040277,1040613,336,-1,2,chrXV
1028193,1028625,432,-1,2,chrXV
1017879,1018746,867,-1,2,chrXV
986898,988782,1884,-1,2,chrXV
977193,978069,876,-1,2,chrXV
921534,922905,1371,-1,2,chrXV
901857,902874,1017,-1,2,chrXV
900249,900690,441,-1,2,chrXV
899055,899928,873,-1,2,chrXV
896697,897078,381,-1,2,chrXV
889866,891432,1566,-1,2,chrXV
879861,880515,654,-1,2,chrXV
852120,853077,957,-1,2,chrXV
828051,830574,2523,-1,2,chrXV
827421,827862,441,-1,2,chrXV
812394,813708,1314,-1,2,chrXV
761613,762084,471,-1,2,chrXV
760824,761265,441,-1,2,chrXV
746724,747282,558,-1,2,chrXV
744534,745281,747,-1,2,chrXV
704418,708459,4041,-1,2,chrXV
671844,672411,567,-1,2,chrXV
665784,667179,1395,-1,2,chrXV
659814,661674,1860,-1,2,chrXV
651375,651840,465,-1,2,chrXV
633924,634296,372,-1,2,chrXV
628359,630540,2181,-1,2,chrXV
617517,618288,771,-1,2,chrXV
612996,616671,3675,-1,2,chrXV
609837,611388,1551,-1,2,chrXV
605346,606171,825,-1,2,chrXV
589941,592587,2646,-1,2,chrXV
587616,587943,327,-1,2,chrXV
580158,580500,342,-1,2,chrXV
572181,572838,657,-1,2,chrXV
569928,570807,879,-1,2,chrXV
559029,559848,819,-1,2,chrXV
554823,558642,3819,-1,2,chrXV
513294,514278,984,-1,2,chrXV
497505,502452,4947,-1,2,chrXV
493419,494400,981,-1,2,chrXV
482310,482724,414,-1,2,chrXV
479295,479637,342,-1,2,chrXV
466674,467589,915,-1,2,chrXV
451728,453462,1734,-1,2,chrXV
426771,427224,453,-1,2,chrXV
424845,426084,1239,-1,2,chrXV
424269,424617,348,-1,2,chrXV
422667,423816,1149,-1,2,chrXV
418629,421650,3021,-1,2,chrXV
416346,417681,1335,-1,2,chrXV
411825,412263,438,-1,2,chrXV
408357,408789,432,-1,2,chrXV
397734,400104,2370,-1,2,chrXV
394836,397086,2250,-1,2,chrXV
392415,394524,2109,-1,2,chrXV
388212,388533,321,-1,2,chrXV
383532,384420,888,-1,2,chrXV
376011,377712,1701,-1,2,chrXV
346194,346950,756,-1,2,chrXV
341277,342414,1137,-1,2,chrXV
338937,339978,1041,-1,2,chrXV
313077,315387,2310,-1,2,chrXV
290880,292074,1194,-1,2,chrXV
286776,287214,438,-1,2,chrXV
282420,285426,3006,-1,2,chrXV
274011,274353,342,-1,2,chrXV
269814,270420,606,-1,2,chrXV
256665,257019,354,-1,2,chrXV
248391,249534,1143,-1,2,chrXV
245739,246072,333,-1,2,chrXV
243465,244140,675,-1,2,chrXV
210519,211995,1476,-1,2,chrXV
202695,204471,1776,-1,2,chrXV
201984,202518,534,-1,2,chrXV
200367,201879,1512,-1,2,chrXV
189657,193542,3885,-1,2,chrXV
185847,186723,876,-1,2,chrXV
177402,177711,309,-1,2,chrXV
155286,158637,3351,-1,2,chrXV
126981,127920,939,-1,2,chrXV
125109,125409,300,-1,2,chrXV
110307,110628,321,-1,2,chrXV
92025,92328,303,-1,2,chrXV
89691,91419,1728,-1,2,chrXV
85455,86757,1302,-1,2,chrXV
84474,84870,396,-1,2,chrXV
81786,83058,1272,-1,2,chrXV
78351,79479,1128,-1,2,chrXV
70155,70545,390,-1,2,chrXV
69375,70044,669,-1,2,chrXV
67560,68754,1194,-1,2,chrXV
54594,55104,510,-1,2,chrXV
49554,52788,3234,-1,2,chrXV
45759,47574,1815,-1,2,chrXV
44472,44784,312,-1,2,chrXV
28977,29328,351,-1,2,chrXV
22524,24294,1770,-1,2,chrXV
17280,17796,516,-1,2,chrXV
999,1338,339,-1,2,chrXV
642,1125,483,1,0,chrXVI
1425,2001,576,1,0,chrXVI
4158,4509,351,1,0,chrXVI
11886,12600,714,1,0,chrXVI
15435,15795,360,1,0,chrXVI
25086,26064,978,1,0,chrXVI
33012,34947,1935,1,0,chrXVI
35235,37845,2610,1,0,chrXVI
39120,40077,957,1,0,chrXVI
49302,50958,1656,1,0,chrXVI
58548,62016,3468,1,0,chrXVI
99483,100086,603,1,0,chrXVI
107274,108147,873,1,0,chrXVI
108651,114315,5664,1,0,chrXVI
115311,116487,1176,1,0,chrXVI
117066,117687,621,1,0,chrXVI
130161,132228,2067,1,0,chrXVI
135789,136443,654,1,0,chrXVI
136749,138228,1479,1,0,chrXVI
141036,141726,690,1,0,chrXVI
143820,147129,3309,1,0,chrXVI
148812,149121,309,1,0,chrXVI
171483,171954,471,1,0,chrXVI
189153,190983,1830,1,0,chrXVI
193647,194145,498,1,0,chrXVI
195252,195648,396,1,0,chrXVI
212157,212784,627,1,0,chrXVI
231216,232509,1293,1,0,chrXVI
280479,280926,447,1,0,chrXVI
297552,298050,498,1,0,chrXVI
303120,304014,894,1,0,chrXVI
304386,305058,672,1,0,chrXVI
310209,312900,2691,1,0,chrXVI
351942,352251,309,1,0,chrXVI
353910,354273,363,1,0,chrXVI
370977,372921,1944,1,0,chrXVI
375501,376953,1452,1,0,chrXVI
383454,384408,954,1,0,chrXVI
387066,393654,6588,1,0,chrXVI
410442,411285,843,1,0,chrXVI
412827,415362,2535,1,0,chrXVI
427926,428655,729,1,0,chrXVI
459072,459678,606,1,0,chrXVI
464400,465648,1248,1,0,chrXVI
467259,469656,2397,1,0,chrXVI
469938,471996,2058,1,0,chrXVI
480534,481068,534,1,0,chrXVI
486711,487209,498,1,0,chrXVI
493542,495246,1704,1,0,chrXVI
517650,518760,1110,1,0,chrXVI
521013,524958,3945,1,0,chrXVI
529722,533409,3687,1,0,chrXVI
535017,535587,570,1,0,chrXVI
554604,555729,1125,1,0,chrXVI
558384,559935,1551,1,0,chrXVI
615378,619014,3636,1,0,chrXVI
627879,631245,3366,1,0,chrXVI
634122,637224,3102,1,0,chrXVI
642207,643320,1113,1,0,chrXVI
647304,648375,1071,1,0,chrXVI
657513,658938,1425,1,0,chrXVI
659181,661053,1872,1,0,chrXVI
661743,662133,390,1,0,chrXVI
664959,665490,531,1,0,chrXVI
666279,667446,1167,1,0,chrXVI
679692,680799,1107,1,0,chrXVI
698868,700014,1146,1,0,chrXVI
700593,701970,1377,1,0,chrXVI
702189,702675,486,1,0,chrXVI
703329,703674,345,1,0,chrXVI
704853,706593,1740,1,0,chrXVI
706971,708342,1371,1,0,chrXVI
710100,711138,1038,1,0,chrXVI
713274,715941,2667,1,0,chrXVI
720636,720960,324,1,0,chrXVI
730491,731019,528,1,0,chrXVI
732348,733212,864,1,0,chrXVI
751392,751824,432,1,0,chrXVI
752256,752919,663,1,0,chrXVI
753300,754248,948,1,0,chrXVI
767751,768987,1236,1,0,chrXVI
786207,787428,1221,1,0,chrXVI
796575,796902,327,1,0,chrXVI
799233,802017,2784,1,0,chrXVI
818322,819075,753,1,0,chrXVI
829917,830439,522,1,0,chrXVI
834564,835212,648,1,0,chrXVI
843261,844020,759,1,0,chrXVI
867135,867486,351,1,0,chrXVI
870702,874926,4224,1,0,chrXVI
875367,875997,630,1,0,chrXVI
883827,885558,1731,1,0,chrXVI
885795,886398,603,1,0,chrXVI
886917,887538,621,1,0,chrXVI
902043,906654,4611,1,0,chrXVI
912126,912435,309,1,0,chrXVI
912663,916962,4299,1,0,chrXVI
919380,920487,1107,1,0,chrXVI
939921,941136,1215,1,0,chrXVI
943371,943896,525,1,0,chrXVI
1411,1918,507,1,1,chrXVI
2287,2623,336,1,1,chrXVI
13330,13651,321,1,1,chrXVI
17947,18385,438,1,1,chrXVI
30340,32803,2463,1,1,chrXVI
47335,48802,1467,1,1,chrXVI
69484,70951,1467,1,1,chrXVI
73624,73927,303,1,1,chrXVI
85585,86950,1365,1,1,chrXVI
88516,90316,1800,1,1,chrXVI
100495,101353,858,1,1,chrXVI
103231,104647,1416,1,1,chrXVI
106171,106822,651,1,1,chrXVI
116176,116482,306,1,1,chrXVI
118381,120031,1650,1,1,chrXVI
120322,120733,411,1,1,chrXVI
133042,135424,2382,1,1,chrXVI
147415,148423,1008,1,1,chrXVI
150613,151330,717,1,1,chrXVI
164275,165760,1485,1,1,chrXVI
166255,167398,1143,1,1,chrXVI
168466,168871,405,1,1,chrXVI
173533,173884,351,1,1,chrXVI
175042,175864,822,1,1,chrXVI
181402,182548,1146,1,1,chrXVI
208156,209806,1650,1,1,chrXVI
228313,228772,459,1,1,chrXVI
237337,237979,642,1,1,chrXVI
240826,241147,321,1,1,chrXVI
265027,266104,1077,1,1,chrXVI
271309,272194,885,1,1,chrXVI
313387,316486,3099,1,1,chrXVI
329605,331699,2094,1,1,chrXVI
335947,336367,420,1,1,chrXVI
339943,340945,1002,1,1,chrXVI
348445,348952,507,1,1,chrXVI
353935,354331,396,1,1,chrXVI
355699,357676,1977,1,1,chrXVI
360208,361579,1371,1,1,chrXVI
364951,366430,1479,1,1,chrXVI
373792,375169,1377,1,1,chrXVI
381964,382993,1029,1,1,chrXVI
407095,407539,444,1,1,chrXVI
415762,418027,2265,1,1,chrXVI
425461,425824,363,1,1,chrXVI
426232,427672,1440,1,1,chrXVI
455758,456664,906,1,1,chrXVI
462724,463060,336,1,1,chrXVI
465961,466261,300,1,1,chrXVI
479224,480175,951,1,1,chrXVI
482842,485686,2844,1,1,chrXVI
495505,497719,2214,1,1,chrXVI
521827,522190,363,1,1,chrXVI
544630,548143,3513,1,1,chrXVI
548485,550306,1821,1,1,chrXVI
552019,553408,1389,1,1,chrXVI
594475,596296,1821,1,1,chrXVI
596749,599551,2802,1,1,chrXVI
599869,600217,348,1,1,chrXVI
610480,612724,2244,1,1,chrXVI
647011,647347,336,1,1,chrXVI
648703,649921,1218,1,1,chrXVI
667675,670873,3198,1,1,chrXVI
671125,672142,1017,1,1,chrXVI
673750,674674,924,1,1,chrXVI
677164,677641,477,1,1,chrXVI
682219,682777,558,1,1,chrXVI
685897,687598,1701,1,1,chrXVI
688171,688807,636,1,1,chrXVI
690106,691789,1683,1,1,chrXVI
696475,696850,375,1,1,chrXVI
711520,711877,357,1,1,chrXVI
718378,718684,306,1,1,chrXVI
723679,724003,324,1,1,chrXVI
729790,730213,423,1,1,chrXVI
742453,743743,1290,1,1,chrXVI
744688,745573,885,1,1,chrXVI
754876,758128,3252,1,1,chrXVI
758647,759481,834,1,1,chrXVI
760024,767494,7470,1,1,chrXVI
771652,773128,1476,1,1,chrXVI
778582,780301,1719,1,1,chrXVI
782044,785671,3627,1,1,chrXVI
787960,789325,1365,1,1,chrXVI
814390,815536,1146,1,1,chrXVI
817072,817633,561,1,1,chrXVI
822619,824338,1719,1,1,chrXVI
830998,831520,522,1,1,chrXVI
844708,846031,1323,1,1,chrXVI
878623,880168,1545,1,1,chrXVI
888964,891043,2079,1,1,chrXVI
895960,897004,1044,1,1,chrXVI
900754,901558,804,1,1,chrXVI
921859,922777,918,1,1,chrXVI
931375,932788,1413,1,1,chrXVI
934033,935665,1632,1,1,chrXVI
943879,944188,309,1,1,chrXVI
944602,947701,3099,1,1,chrXVI
18368,19079,711,1,2,chrXVI
22937,24701,1764,1,2,chrXVI
38168,38798,630,1,2,chrXVI
41042,42869,1827,1,2,chrXVI
43958,44276,318,1,2,chrXVI
54614,54965,351,1,2,chrXVI
56747,58070,1323,1,2,chrXVI
63278,63860,582,1,2,chrXVI
67724,68882,1158,1,2,chrXVI
121766,125357,3591,1,2,chrXVI
126005,126446,441,1,2,chrXVI
138959,139409,450,1,2,chrXVI
153494,154040,546,1,2,chrXVI
157841,159593,1752,1,2,chrXVI
159908,162341,2433,1,2,chrXVI
176222,179021,2799,1,2,chrXVI
179276,181115,1839,1,2,chrXVI
187202,187655,453,1,2,chrXVI
191405,192650,1245,1,2,chrXVI
203420,204941,1521,1,2,chrXVI
205247,207647,2400,1,2,chrXVI
218747,220088,1341,1,2,chrXVI
223142,224036,894,1,2,chrXVI
246989,250262,3273,1,2,chrXVI
254813,255761,948,1,2,chrXVI
257948,258305,357,1,2,chrXVI
268187,270893,2706,1,2,chrXVI
273254,275867,2613,1,2,chrXVI
295625,296249,624,1,2,chrXVI
296285,296654,369,1,2,chrXVI
301715,302618,903,1,2,chrXVI
316754,317516,762,1,2,chrXVI
320087,320417,330,1,2,chrXVI
322070,323744,1674,1,2,chrXVI
326627,327662,1035,1,2,chrXVI
349118,349865,747,1,2,chrXVI
361871,363362,1491,1,2,chrXVI
366926,368018,1092,1,2,chrXVI
394037,396572,2535,1,2,chrXVI
396704,397064,360,1,2,chrXVI
403202,403625,423,1,2,chrXVI
418511,420011,1500,1,2,chrXVI
420947,422786,1839,1,2,chrXVI
429938,431369,1431,1,2,chrXVI
431894,432299,405,1,2,chrXVI
432587,434090,1503,1,2,chrXVI
434522,435764,1242,1,2,chrXVI
444578,445031,453,1,2,chrXVI
459962,460559,597,1,2,chrXVI
489764,490163,399,1,2,chrXVI
498095,499292,1197,1,2,chrXVI
499664,500402,738,1,2,chrXVI
503516,504242,726,1,2,chrXVI
506696,509999,3303,1,2,chrXVI
511100,511664,564,1,2,chrXVI
515921,516323,402,1,2,chrXVI
527546,528692,1146,1,2,chrXVI
536438,536852,414,1,2,chrXVI
539384,541970,2586,1,2,chrXVI
556376,557837,1461,1,2,chrXVI
573017,575102,2085,1,2,chrXVI
576551,577358,807,1,2,chrXVI
631514,633761,2247,1,2,chrXVI
639524,640958,1434,1,2,chrXVI
643835,645272,1437,1,2,chrXVI
646835,647195,360,1,2,chrXVI
656798,657344,546,1,2,chrXVI
672470,673496,1026,1,2,chrXVI
678950,679370,420,1,2,chrXVI
681212,682112,900,1,2,chrXVI
711353,711674,321,1,2,chrXVI
724229,724571,342,1,2,chrXVI
725393,728615,3222,1,2,chrXVI
740060,741392,1332,1,2,chrXVI
747305,749000,1695,1,2,chrXVI
790082,791120,1038,1,2,chrXVI
792686,793736,1050,1,2,chrXVI
798050,798857,807,1,2,chrXVI
802358,804080,1722,1,2,chrXVI
833810,834245,435,1,2,chrXVI
841265,842669,1404,1,2,chrXVI
846509,849980,3471,1,2,chrXVI
857582,859745,2163,1,2,chrXVI
861305,864014,2709,1,2,chrXVI
878075,878549,474,1,2,chrXVI
889274,889577,303,1,2,chrXVI
892331,893729,1398,1,2,chrXVI
907217,909434,2217,1,2,chrXVI
917573,917897,324,1,2,chrXVI
945932,946616,684,1,2,chrXVI
945954,946569,615,-1,0,chrXVI
945249,945585,336,-1,0,chrXVI
933897,934461,564,-1,0,chrXVI
924303,926937,2634,-1,0,chrXVI
922908,923379,471,-1,0,chrXVI
922125,922494,369,-1,0,chrXVI
917076,919041,1965,-1,0,chrXVI
909732,911022,1290,-1,0,chrXVI
908013,908340,327,-1,0,chrXVI
901095,901425,330,-1,0,chrXVI
897360,899667,2307,-1,0,chrXVI
895896,896196,300,-1,0,chrXVI
893796,895764,1968,-1,0,chrXVI
888042,888708,666,-1,0,chrXVI
876846,877632,786,-1,0,chrXVI
868644,869955,1311,-1,0,chrXVI
854934,856257,1323,-1,0,chrXVI
831054,831675,621,-1,0,chrXVI
815733,817923,2190,-1,0,chrXVI
800490,800814,324,-1,0,chrXVI
791217,792204,987,-1,0,chrXVI
789003,789312,309,-1,0,chrXVI
784110,784479,369,-1,0,chrXVI
778890,779256,366,-1,0,chrXVI
773874,775182,1308,-1,0,chrXVI
745827,746835,1008,-1,0,chrXVI
736983,739569,2586,-1,0,chrXVI
731223,731748,525,-1,0,chrXVI
729756,730113,357,-1,0,chrXVI
728946,729273,327,-1,0,chrXVI
711402,713028,1626,-1,0,chrXVI
700779,701757,978,-1,0,chrXVI
697146,698265,1119,-1,0,chrXVI
695736,696819,1083,-1,0,chrXVI
691932,692418,486,-1,0,chrXVI
690792,691125,333,-1,0,chrXVI
684555,685437,882,-1,0,chrXVI
677811,678120,309,-1,0,chrXVI
674313,674700,387,-1,0,chrXVI
665787,666243,456,-1,0,chrXVI
649518,649869,351,-1,0,chrXVI
624468,626967,2499,-1,0,chrXVI
620424,621258,834,-1,0,chrXVI
600648,603357,2709,-1,0,chrXVI
584631,585585,954,-1,0,chrXVI
577584,581196,3612,-1,0,chrXVI
564006,565041,1035,-1,0,chrXVI
559332,559647,315,-1,0,chrXVI
553626,554328,702,-1,0,chrXVI
546174,546480,306,-1,0,chrXVI
528984,529350,366,-1,0,chrXVI
518733,520233,1500,-1,0,chrXVI
488886,491364,2478,-1,0,chrXVI
485154,485517,363,-1,0,chrXVI
475992,479001,3009,-1,0,chrXVI
462480,463839,1359,-1,0,chrXVI
453429,453735,306,-1,0,chrXVI
451908,453057,1149,-1,0,chrXVI
425250,425847,597,-1,0,chrXVI
408009,408744,735,-1,0,chrXVI
379119,381150,2031,-1,0,chrXVI
368070,369441,1371,-1,0,chrXVI
363519,364068,549,-1,0,chrXVI
357999,359406,1407,-1,0,chrXVI
350193,352275,2082,-1,0,chrXVI
341067,344739,3672,-1,0,chrXVI
340308,340695,387,-1,0,chrXVI
335952,337143,1191,-1,0,chrXVI
320961,321630,669,-1,0,chrXVI
317640,318945,1305,-1,0,chrXVI
289668,291051,1383,-1,0,chrXVI
278394,279699,1305,-1,0,chrXVI
261726,264192,2466,-1,0,chrXVI
259713,260931,1218,-1,0,chrXVI
255912,256767,855,-1,0,chrXVI
252033,254310,2277,-1,0,chrXVI
241917,242700,783,-1,0,chrXVI
239349,241497,2148,-1,0,chrXVI
229038,230838,1800,-1,0,chrXVI
224352,225741,1389,-1,0,chrXVI
199494,202536,3042,-1,0,chrXVI
197259,197580,321,-1,0,chrXVI
194511,195426,915,-1,0,chrXVI
185316,187725,2409,-1,0,chrXVI
174342,174756,414,-1,0,chrXVI
172032,172755,723,-1,0,chrXVI
168087,169338,1251,-1,0,chrXVI
156489,157593,1104,-1,0,chrXVI
134946,135402,456,-1,0,chrXVI
130899,131259,360,-1,0,chrXVI
128631,129138,507,-1,0,chrXVI
126633,128088,1455,-1,0,chrXVI
120162,121167,1005,-1,0,chrXVI
101607,102702,1095,-1,0,chrXVI
100473,100863,390,-1,0,chrXVI
96495,98625,2130,-1,0,chrXVI
90621,95109,4488,-1,0,chrXVI
79710,82356,2646,-1,0,chrXVI
76668,79353,2685,-1,0,chrXVI
73362,73881,519,-1,0,chrXVI
51243,52671,1428,-1,0,chrXVI
44550,46506,1956,-1,0,chrXVI
30783,31104,321,-1,0,chrXVI
30348,30729,381,-1,0,chrXVI
26610,28164,1554,-1,0,chrXVI
13227,14355,1128,-1,0,chrXVI
7932,8427,495,-1,0,chrXVI
279,5667,5388,-1,0,chrXVI
939278,939671,393,-1,1,chrXVI
938147,939032,885,-1,1,chrXVI
911987,912479,492,-1,1,chrXVI
903503,903872,369,-1,1,chrXVI
888284,888635,351,-1,1,chrXVI
886523,887837,1314,-1,1,chrXVI
876281,876629,348,-1,1,chrXVI
868859,869441,582,-1,1,chrXVI
866714,868304,1590,-1,1,chrXVI
850988,854456,3468,-1,1,chrXVI
837908,839777,1869,-1,1,chrXVI
835562,837413,1851,-1,1,chrXVI
826832,828140,1308,-1,1,chrXVI
825644,826559,915,-1,1,chrXVI
819764,821423,1659,-1,1,chrXVI
818129,818693,564,-1,1,chrXVI
813155,814058,903,-1,1,chrXVI
810983,812453,1470,-1,1,chrXVI
808946,810269,1323,-1,1,chrXVI
795977,797210,1233,-1,1,chrXVI
793910,794666,756,-1,1,chrXVI
793373,793781,408,-1,1,chrXVI
786140,786575,435,-1,1,chrXVI
768491,768893,402,-1,1,chrXVI
749255,751919,2664,-1,1,chrXVI
741437,742064,627,-1,1,chrXVI
733622,736433,2811,-1,1,chrXVI
724841,725144,303,-1,1,chrXVI
710309,710738,429,-1,1,chrXVI
705881,706493,612,-1,1,chrXVI
702113,703970,1857,-1,1,chrXVI
697130,697502,372,-1,1,chrXVI
692795,694838,2043,-1,1,chrXVI
682940,684353,1413,-1,1,chrXVI
681329,681749,420,-1,1,chrXVI
664952,665366,414,-1,1,chrXVI
661136,664673,3537,-1,1,chrXVI
655139,656552,1413,-1,1,chrXVI
613376,614558,1182,-1,1,chrXVI
608825,610031,1206,-1,1,chrXVI
592331,593069,738,-1,1,chrXVI
590282,591026,744,-1,1,chrXVI
583061,584042,981,-1,1,chrXVI
561503,563768,2265,-1,1,chrXVI
550631,551657,1026,-1,1,chrXVI
542081,543848,1767,-1,1,chrXVI
530270,530729,459,-1,1,chrXVI
525809,526883,1074,-1,1,chrXVI
512312,514178,1866,-1,1,chrXVI
504338,506312,1974,-1,1,chrXVI
502472,503030,558,-1,1,chrXVI
492017,492926,909,-1,1,chrXVI
487361,488207,846,-1,1,chrXVI
486563,486911,348,-1,1,chrXVI
481427,481901,474,-1,1,chrXVI
473039,474707,1668,-1,1,chrXVI
470831,471248,417,-1,1,chrXVI
469925,470474,549,-1,1,chrXVI
466643,466943,300,-1,1,chrXVI
460778,461966,1188,-1,1,chrXVI
445841,450377,4536,-1,1,chrXVI
439427,442742,3315,-1,1,chrXVI
424214,425096,882,-1,1,chrXVI
420047,420518,471,-1,1,chrXVI
419549,419852,303,-1,1,chrXVI
409367,410090,723,-1,1,chrXVI
396701,398105,1404,-1,1,chrXVI
364385,364727,342,-1,1,chrXVI
360002,360305,303,-1,1,chrXVI
352862,355412,2550,-1,1,chrXVI
332099,335486,3387,-1,1,chrXVI
327863,328730,867,-1,1,chrXVI
324410,326264,1854,-1,1,chrXVI
291365,292427,1062,-1,1,chrXVI
287513,289034,1521,-1,1,chrXVI
283463,286061,2598,-1,1,chrXVI
276161,277529,1368,-1,1,chrXVI
232592,237107,4515,-1,1,chrXVI
231302,231644,342,-1,1,chrXVI
220166,222773,2607,-1,1,chrXVI
216011,218363,2352,-1,1,chrXVI
213041,213962,921,-1,1,chrXVI
183596,184679,1083,-1,1,chrXVI
182654,183056,402,-1,1,chrXVI
169769,171155,1386,-1,1,chrXVI
154289,156230,1941,-1,1,chrXVI
151514,153149,1635,-1,1,chrXVI
148568,150191,1623,-1,1,chrXVI
147515,147821,306,-1,1,chrXVI
139619,143171,3552,-1,1,chrXVI
112268,112607,339,-1,1,chrXVI
109118,109520,402,-1,1,chrXVI
104945,105440,495,-1,1,chrXVI
89573,89921,348,-1,1,chrXVI
64976,66614,1638,-1,1,chrXVI
48995,49304,309,-1,1,chrXVI
15404,16868,1464,-1,1,chrXVI
1364,1940,576,-1,1,chrXVI
946855,947338,483,-1,2,chrXVI
945871,946555,684,-1,2,chrXVI
927964,928294,330,-1,2,chrXVI
892312,892684,372,-1,2,chrXVI
891100,892078,978,-1,2,chrXVI
887143,887452,309,-1,2,chrXVI
882982,883318,336,-1,2,chrXVI
864448,866422,1974,-1,2,chrXVI
832060,833458,1398,-1,2,chrXVI
825346,825676,330,-1,2,chrXVI
805000,808468,3468,-1,2,chrXVI
802324,802837,513,-1,2,chrXVI
789076,789385,309,-1,2,chrXVI
725869,726181,312,-1,2,chrXVI
721036,724717,3681,-1,2,chrXVI
719557,720490,933,-1,2,chrXVI
716155,718468,2313,-1,2,chrXVI
708496,709843,1347,-1,2,chrXVI
704224,704656,432,-1,2,chrXVI
681574,681913,339,-1,2,chrXVI
675976,676882,906,-1,2,chrXVI
674860,675631,771,-1,2,chrXVI
654523,654877,354,-1,2,chrXVI
650434,653662,3228,-1,2,chrXVI
646447,647038,591,-1,2,chrXVI
640471,640810,339,-1,2,chrXVI
637378,639019,1641,-1,2,chrXVI
633205,633586,381,-1,2,chrXVI
603910,607312,3402,-1,2,chrXVI
593485,593917,432,-1,2,chrXVI
587188,587518,330,-1,2,chrXVI
569335,571378,2043,-1,2,chrXVI
567268,568996,1728,-1,2,chrXVI
565786,566671,885,-1,2,chrXVI
535819,538936,3117,-1,2,chrXVI
533641,534703,1062,-1,2,chrXVI
528175,528574,399,-1,2,chrXVI
514510,517018,2508,-1,2,chrXVI
506977,507379,402,-1,2,chrXVI
500674,502183,1509,-1,2,chrXVI
475117,475741,624,-1,2,chrXVI
457117,458458,1341,-1,2,chrXVI
453991,454990,999,-1,2,chrXVI
437332,439495,2163,-1,2,chrXVI
433087,433447,360,-1,2,chrXVI
428710,429616,906,-1,2,chrXVI
422884,423892,1008,-1,2,chrXVI
422029,422419,390,-1,2,chrXVI
421369,421867,498,-1,2,chrXVI
418498,418984,486,-1,2,chrXVI
406171,406498,327,-1,2,chrXVI
398479,404083,5604,-1,2,chrXVI
384772,386446,1674,-1,2,chrXVI
377290,377815,525,-1,2,chrXVI
369838,370690,852,-1,2,chrXVI
361930,362365,435,-1,2,chrXVI
345556,347389,1833,-1,2,chrXVI
337435,338620,1185,-1,2,chrXVI
319225,320767,1542,-1,2,chrXVI
308827,309604,777,-1,2,chrXVI
306532,308221,1689,-1,2,chrXVI
299887,301228,1341,-1,2,chrXVI
298570,299503,933,-1,2,chrXVI
292816,296647,3831,-1,2,chrXVI
282685,283003,318,-1,2,chrXVI
272293,272827,534,-1,2,chrXVI
266179,267535,1356,-1,2,chrXVI
257215,259336,2121,-1,2,chrXVI
255235,255586,351,-1,2,chrXVI
250906,251668,762,-1,2,chrXVI
244318,246220,1902,-1,2,chrXVI
243205,244027,822,-1,2,chrXVI
237955,239077,1122,-1,2,chrXVI
226168,227371,1203,-1,2,chrXVI
219106,219466,360,-1,2,chrXVI
203305,203689,384,-1,2,chrXVI
195949,197788,1839,-1,2,chrXVI
179539,179920,381,-1,2,chrXVI
176563,176983,420,-1,2,chrXVI
163921,164266,345,-1,2,chrXVI
162631,163597,966,-1,2,chrXVI
87013,88033,1020,-1,2,chrXVI
84508,85297,789,-1,2,chrXVI
82624,84196,1572,-1,2,chrXVI
74308,74719,411,-1,2,chrXVI
71062,73006,1944,-1,2,chrXVI
53497,55153,1656,-1,2,chrXVI
43282,44344,1062,-1,2,chrXVI
15052,15355,303,-1,2,chrXVI
9556,10870,1314,-1,2,chrXVI
18919,19273,354,1,1,chrM
19489,19843,354,1,1,chrM
14300,14924,624,1,2,chrM
17129,17504,375,1,2,chrM
17552,18119,567,1,2,chrM
18137,18830,693,1,2,chrM
37790,38201,411,1,2,chrM
14434,14746,312,-1,2,chrM
