start,end,length,strand,frame,chromosome,label
12045,12426,381,1,0,chrI,known_gene
24477,24879,402,1,0,chrI,novel_orf
26733,27159,426,1,0,chrI,novel_orf
31566,32940,1374,1,0,chrI,known_gene
33447,34701,1254,1,0,chrI,known_gene
35154,36303,1149,1,0,chrI,known_gene
39258,41901,2643,1,0,chrI,known_gene
59052,59409,357,1,0,chrI,novel_orf
74019,74823,804,1,0,chrI,known_gene
94686,95472,786,1,0,chrI,known_gene
104526,104847,321,1,0,chrI,novel_orf
114249,114819,570,1,0,chrI,known_gene
114918,118314,3396,1,0,chrI,known_gene
124878,126786,1908,1,0,chrI,known_gene
132159,134076,1917,1,0,chrI,known_gene
143706,147531,3825,1,0,chrI,known_gene
149400,149841,441,1,0,chrI,novel_orf
152256,153876,1620,1,0,chrI,known_gene
155004,156285,1281,1,0,chrI,known_gene
169374,170295,921,1,0,chrI,known_gene
177093,177450,357,1,0,chrI,novel_orf
188106,188811,705,1,0,chrI,known_gene
192618,196185,3567,1,0,chrI,known_gene
220197,220497,300,1,0,chrI,known_gene
222405,222891,486,1,0,chrI,known_gene
225459,226863,1404,1,0,chrI,known_gene
228843,229317,474,1,0,chrI,known_gene
334,649,315,1,1,chrI,known_gene
10090,10399,309,1,1,chrI,known_gene
36508,37147,639,1,1,chrI,known_gene
45898,48250,2352,1,1,chrI,known_gene
54583,54913,330,1,1,chrI,known_gene
57517,57850,333,1,1,chrI,known_gene
61315,62563,1248,1,1,chrI,known_gene
62839,65404,2565,1,1,chrI,known_gene
69046,69505,459,1,1,chrI,novel_orf
71785,73288,1503,1,1,chrI,known_gene
76426,79435,3009,1,1,chrI,known_gene
79717,80587,870,1,1,chrI,known_gene
82705,83227,522,1,1,chrI,known_gene
92899,94486,1587,1,1,chrI,known_gene
109387,109801,414,1,1,chrI,novel_orf
130798,131983,1185,1,1,chrI,known_gene
135853,136633,780,1,1,chrI,known_gene
158890,159793,903,1,1,chrI,known_gene
174997,175330,333,1,1,chrI,known_gene
183769,184477,708,1,1,chrI,known_gene
184891,185596,705,1,1,chrI,known_gene
186835,187732,897,1,1,chrI,known_gene
190192,192256,2064,1,1,chrI,known_gene
218548,219145,597,1,1,chrI,novel_orf
37463,38972,1509,1,2,chrI,known_gene
42176,42719,543,1,2,chrI,known_gene
48563,51707,3144,1,2,chrI,known_gene
57137,57437,300,1,2,chrI,novel_orf
77390,77693,303,1,2,chrI,known_gene
84668,84977,309,1,2,chrI,known_gene
112961,113336,375,1,2,chrI,novel_orf
120224,124295,4071,1,2,chrI,known_gene
128561,128999,438,1,2,chrI,novel_orf
129269,130487,1218,1,2,chrI,known_gene
136913,137510,597,1,2,chrI,known_gene
140759,141407,648,1,2,chrI,known_gene
190421,191003,582,1,2,chrI,known_gene
203402,208016,4614,1,2,chrI,known_gene
221048,221660,612,1,2,chrI,known_gene
227741,228953,1212,1,2,chrI,known_gene
217156,217492,336,-1,0,chrI,known_gene
207130,207511,381,-1,0,chrI,novel_orf
204211,204637,426,-1,0,chrI,novel_orf
201466,201787,321,-1,0,chrI,known_gene
191179,191539,360,-1,0,chrI,novel_orf
186511,186853,342,-1,0,chrI,known_gene
172210,175135,2925,-1,0,chrI,known_gene
170395,171703,1308,-1,0,chrI,known_gene
166741,168871,2130,-1,0,chrI,known_gene
128251,129019,768,-1,0,chrI,known_gene
113875,114208,333,-1,0,chrI,known_gene
110845,113359,2514,-1,0,chrI,known_gene
109576,109912,336,-1,0,chrI,known_gene
95629,99697,4068,-1,0,chrI,known_gene
84748,87031,2283,-1,0,chrI,known_gene
77188,77665,477,-1,0,chrI,novel_orf
72325,73300,975,-1,0,chrI,known_gene
57949,58483,534,-1,0,chrI,known_gene
57487,57796,309,-1,0,chrI,known_gene
57028,57385,357,-1,0,chrI,known_gene
54988,56857,1869,-1,0,chrI,known_gene
50818,51124,306,-1,0,chrI,novel_orf
42880,45022,2142,-1,0,chrI,known_gene
38695,39046,351,-1,0,chrI,known_gene
7234,9016,1782,-1,0,chrI,known_gene
224562,224862,300,-1,1,chrI,known_gene
179280,179820,540,-1,1,chrI,known_gene
160596,164187,3591,-1,1,chrI,novel_orf
156753,158619,1866,-1,1,chrI,known_gene
137697,138345,648,-1,1,chrI,known_gene
118563,119541,978,-1,1,chrI,known_gene
115869,116418,549,-1,1,chrI,novel_orf
113613,114615,1002,-1,1,chrI,known_gene
108876,110430,1554,-1,1,chrI,known_gene
100224,101145,921,-1,1,chrI,known_gene
95385,95823,438,-1,1,chrI,known_gene
83334,84474,1140,-1,1,chrI,known_gene
80709,82101,1392,-1,1,chrI,known_gene
79488,79842,354,-1,1,chrI,known_gene
78387,78933,546,-1,1,chrI,novel_orf
75042,76152,1110,-1,1,chrI,known_gene
72213,72696,483,-1,1,chrI,known_gene
68715,69525,810,-1,1,chrI,known_gene
61230,61608,378,-1,1,chrI,known_gene
52800,54789,1989,-1,1,chrI,known_gene
36495,36918,423,-1,1,chrI,known_gene
34104,34476,372,-1,1,chrI,novel_orf
13362,13743,381,-1,1,chrI,known_gene
1806,2169,363,-1,1,chrI,known_gene
228536,228863,327,-1,2,chrI,novel_orf
192932,193430,498,-1,2,chrI,novel_orf
164543,165866,1323,-1,2,chrI,novel_orf
157802,158126,324,-1,2,chrI,known_gene
154064,154724,660,-1,2,chrI,known_gene
152477,152879,402,-1,2,chrI,novel_orf
147593,150695,3102,-1,2,chrI,known_gene
142670,142976,306,-1,2,chrI,novel_orf
139502,141431,1929,-1,2,chrI,known_gene
134183,135665,1482,-1,2,chrI,known_gene
126902,128102,1200,-1,2,chrI,known_gene
124754,125069,315,-1,2,chrI,known_gene
106271,108551,2280,-1,2,chrI,known_gene
101564,105872,4308,-1,2,chrI,known_gene
87854,92270,4416,-1,2,chrI,known_gene
65777,67520,1743,-1,2,chrI,known_gene
58694,61052,2358,-1,2,chrI,known_gene
51854,52595,741,-1,2,chrI,known_gene
38216,38573,357,-1,2,chrI,novel_orf
23999,27968,3969,-1,2,chrI,known_gene
11564,11951,387,-1,2,chrI,known_gene
645,1128,483,1,0,chrII,known_gene
1428,2508,1080,1,0,chrII,novel_orf
29934,31251,1317,1,0,chrII,novel_orf
39144,40527,1383,1,0,chrII,known_gene
40830,43095,2265,1,0,chrII,known_gene
71865,72972,1107,1,0,chrII,known_gene
75258,79767,4509,1,0,chrII,known_gene
87645,87957,312,1,0,chrII,known_gene
107931,109995,2064,1,0,chrII,known_gene
117588,119166,1578,1,0,chrII,known_gene
119334,119709,375,1,0,chrII,known_gene
132423,133749,1326,1,0,chrII,known_gene
141246,141972,726,1,0,chrII,known_gene
171480,171918,438,1,0,chrII,known_gene
172533,174588,2055,1,0,chrII,known_gene
176997,177390,393,1,0,chrII,novel_orf
182400,184125,1725,1,0,chrII,known_gene
192450,193512,1062,1,0,chrII,known_gene
194121,195702,1581,1,0,chrII,known_gene
209652,212175,2523,1,0,chrII,known_gene
224400,224712,312,1,0,chrII,novel_orf
242808,244230,1422,1,0,chrII,known_gene
261669,265140,3471,1,0,chrII,novel_orf
270246,270633,387,1,0,chrII,known_gene
281442,283344,1902,1,0,chrII,known_gene
283737,284271,534,1,0,chrII,known_gene
300165,301254,1089,1,0,chrII,known_gene
301518,301821,303,1,0,chrII,known_gene
309366,309735,369,1,0,chrII,novel_orf
382029,382674,645,1,0,chrII,known_gene
403107,403482,375,1,0,chrII,novel_orf
434460,434880,420,1,0,chrII,novel_orf
436020,436713,693,1,0,chrII,known_gene
436950,441315,4365,1,0,chrII,known_gene
447708,449316,1608,1,0,chrII,known_gene
454821,457665,2844,1,0,chrII,known_gene
458871,460221,1350,1,0,chrII,known_gene
463209,463635,426,1,0,chrII,novel_orf
467247,469620,2373,1,0,chrII,known_gene
489450,489759,309,1,0,chrII,novel_orf
502245,502593,348,1,0,chrII,novel_orf
518370,518724,354,1,0,chrII,novel_orf
522210,522513,303,1,0,chrII,novel_orf
524598,524934,336,1,0,chrII,novel_orf
536574,537465,891,1,0,chrII,known_gene
543666,544077,411,1,0,chrII,novel_orf
546375,547251,876,1,0,chrII,known_gene
556548,558198,1650,1,0,chrII,known_gene
558684,559728,1044,1,0,chrII,known_gene
561633,562764,1131,1,0,chrII,known_gene
565722,567480,1758,1,0,chrII,known_gene
568851,569685,834,1,0,chrII,known_gene
572370,573612,1242,1,0,chrII,known_gene
583719,584658,939,1,0,chrII,known_gene
589740,591459,1719,1,0,chrII,known_gene
600552,602163,1611,1,0,chrII,known_gene
606696,607140,444,1,0,chrII,known_gene
620871,622527,1656,1,0,chrII,known_gene
633621,634836,1215,1,0,chrII,known_gene
635145,636543,1398,1,0,chrII,known_gene
638778,639105,327,1,0,chrII,novel_orf
642582,642900,318,1,0,chrII,known_gene
645549,645978,429,1,0,chrII,known_gene
649305,649674,369,1,0,chrII,known_gene
650367,651192,825,1,0,chrII,known_gene
651414,652998,1584,1,0,chrII,known_gene
653445,655317,1872,1,0,chrII,known_gene
657831,658392,561,1,0,chrII,known_gene
670626,673329,2703,1,0,chrII,known_gene
675312,676227,915,1,0,chrII,known_gene
683427,684669,1242,1,0,chrII,known_gene
691968,694518,2550,1,0,chrII,known_gene
705480,705816,336,1,0,chrII,novel_orf
721389,722313,924,1,0,chrII,known_gene
722610,723054,444,1,0,chrII,known_gene
724455,726540,2085,1,0,chrII,known_gene
730386,732453,2067,1,0,chrII,known_gene
734841,735285,444,1,0,chrII,novel_orf
736038,737736,1698,1,0,chrII,known_gene
760293,760899,606,1,0,chrII,known_gene
761256,762594,1338,1,0,chrII,known_gene
774621,776313,1692,1,0,chrII,known_gene
787005,788430,1425,1,0,chrII,known_gene
789234,791814,2580,1,0,chrII,known_gene
805350,807105,1755,1,0,chrII,known_gene
1414,2425,1011,1,1,chrII,novel_orf
8176,8482,306,1,1,chrII,known_gene
24097,24745,648,1,1,chrII,known_gene
27337,27847,510,1,1,chrII,novel_orf
31207,35248,4041,1,1,chrII,novel_orf
43276,44089,813,1,1,chrII,known_gene
49423,50953,1530,1,1,chrII,known_gene
58927,59374,447,1,1,chrII,novel_orf
70042,70540,498,1,1,chrII,novel_orf
80896,81328,432,1,1,chrII,known_gene
81340,81652,312,1,1,chrII,novel_orf
92329,93394,1065,1,1,chrII,known_gene
105307,105688,381,1,1,chrII,known_gene
110593,110896,303,1,1,chrII,known_gene
111436,112708,1272,1,1,chrII,known_gene
113761,115168,1407,1,1,chrII,known_gene
135997,136366,369,1,1,chrII,known_gene
136687,137461,774,1,1,chrII,known_gene
147208,150286,3078,1,1,chrII,known_gene
160183,161329,1146,1,1,chrII,known_gene
161698,162715,1017,1,1,chrII,known_gene
207193,209224,2031,1,1,chrII,known_gene
221329,222652,1323,1,1,chrII,novel_orf
227635,235117,7482,1,1,chrII,known_gene
236491,236887,396,1,1,chrII,known_gene
242053,242356,303,1,1,chrII,novel_orf
245905,246547,642,1,1,chrII,known_gene
247009,248503,1494,1,1,chrII,known_gene
256330,256741,411,1,1,chrII,known_gene
262939,263419,480,1,1,chrII,novel_orf
284809,285166,357,1,1,chrII,novel_orf
289444,290350,906,1,1,chrII,known_gene
298291,299950,1659,1,1,chrII,known_gene
315574,316510,936,1,1,chrII,known_gene
318265,320275,2010,1,1,chrII,known_gene
337987,338338,351,1,1,chrII,known_gene
347878,349384,1506,1,1,chrII,known_gene
367762,368191,429,1,1,chrII,known_gene
380410,381046,636,1,1,chrII,known_gene
390226,391291,1065,1,1,chrII,known_gene
409168,410629,1461,1,1,chrII,known_gene
425182,425782,600,1,1,chrII,known_gene
441514,443590,2076,1,1,chrII,known_gene
463930,464341,411,1,1,chrII,novel_orf
465565,466048,483,1,1,chrII,known_gene
477670,479047,1377,1,1,chrII,known_gene
485650,485992,342,1,1,chrII,novel_orf
504853,505306,453,1,1,chrII,known_gene
513043,513583,540,1,1,chrII,known_gene
528316,530638,2322,1,1,chrII,known_gene
533761,534817,1056,1,1,chrII,known_gene
539986,541021,1035,1,1,chrII,known_gene
547459,548194,735,1,1,chrII,known_gene
560077,560974,897,1,1,chrII,known_gene
605965,606277,312,1,1,chrII,known_gene
607651,608785,1134,1,1,chrII,known_gene
609118,609439,321,1,1,chrII,novel_orf
612865,613708,843,1,1,chrII,novel_orf
623575,624211,636,1,1,chrII,known_gene
625771,628309,2538,1,1,chrII,known_gene
629167,631942,2775,1,1,chrII,known_gene
633994,634312,318,1,1,chrII,known_gene
634600,634924,324,1,1,chrII,known_gene
685450,685765,315,1,1,chrII,novel_orf
707527,708016,489,1,1,chrII,known_gene
719032,720604,1572,1,1,chrII,known_gene
728884,729724,840,1,1,chrII,known_gene
731542,731854,312,1,1,chrII,known_gene
739840,741022,1182,1,1,chrII,known_gene
741298,741616,318,1,1,chrII,known_gene
749593,751177,1584,1,1,chrII,known_gene
769009,769309,300,1,1,chrII,novel_orf
771238,773632,2394,1,1,chrII,known_gene
782590,783556,966,1,1,chrII,known_gene
798169,798502,333,1,1,chrII,novel_orf
809056,809419,363,1,1,chrII,known_gene
5789,6125,336,1,2,chrII,known_gene
37052,38690,1638,1,2,chrII,known_gene
45977,46370,393,1,2,chrII,known_gene
48824,49358,534,1,2,chrII,known_gene
61559,61943,384,1,2,chrII,novel_orf
63875,66818,2943,1,2,chrII,known_gene
90740,92030,1290,1,2,chrII,known_gene
99962,100307,345,1,2,chrII,known_gene
101885,105221,3336,1,2,chrII,known_gene
125303,126119,816,1,2,chrII,known_gene
126827,127244,417,1,2,chrII,known_gene
127298,127610,312,1,2,chrII,known_gene
131024,131345,321,1,2,chrII,novel_orf
146186,146885,699,1,2,chrII,known_gene
153143,153455,312,1,2,chrII,novel_orf
166133,167264,1131,1,2,chrII,known_gene
184352,185915,1563,1,2,chrII,known_gene
200543,200849,306,1,2,chrII,novel_orf
202055,203261,1206,1,2,chrII,known_gene
203537,205817,2280,1,2,chrII,known_gene
217469,220400,2931,1,2,chrII,known_gene
223130,226598,3468,1,2,chrII,novel_orf
259868,261191,1323,1,2,chrII,novel_orf
279020,280607,1587,1,2,chrII,known_gene
301943,304703,2760,1,2,chrII,known_gene
311897,314789,2892,1,2,chrII,known_gene
316967,317864,897,1,2,chrII,known_gene
325004,325346,342,1,2,chrII,novel_orf
331832,332360,528,1,2,chrII,known_gene
333368,333812,444,1,2,chrII,known_gene
343100,344135,1035,1,2,chrII,known_gene
377003,377312,309,1,2,chrII,novel_orf
383111,385988,2877,1,2,chrII,known_gene
386285,389216,2931,1,2,chrII,known_gene
393758,394742,984,1,2,chrII,known_gene
411053,413981,2928,1,2,chrII,known_gene
415982,416906,924,1,2,chrII,known_gene
423764,424829,1065,1,2,chrII,known_gene
432035,434297,2262,1,2,chrII,known_gene
449666,450656,990,1,2,chrII,known_gene
452657,453224,567,1,2,chrII,known_gene
479417,480323,906,1,2,chrII,known_gene
486506,486866,360,1,2,chrII,known_gene
497162,499277,2115,1,2,chrII,known_gene
504242,504644,402,1,2,chrII,known_gene
505667,512774,7107,1,2,chrII,known_gene
515663,517190,1527,1,2,chrII,known_gene
535259,536096,837,1,2,chrII,known_gene
537875,539705,1830,1,2,chrII,known_gene
545027,545978,951,1,2,chrII,known_gene
549770,550928,1158,1,2,chrII,known_gene
578363,578984,621,1,2,chrII,known_gene
581822,582125,303,1,2,chrII,novel_orf
582407,583355,948,1,2,chrII,known_gene
586070,586445,375,1,2,chrII,known_gene
596114,597065,951,1,2,chrII,known_gene
597362,598934,1572,1,2,chrII,known_gene
602633,603476,843,1,2,chrII,known_gene
610037,610409,372,1,2,chrII,known_gene
618908,620303,1395,1,2,chrII,known_gene
647885,649904,2019,1,2,chrII,known_gene
661517,662081,564,1,2,chrII,novel_orf
670124,670640,516,1,2,chrII,known_gene
686900,690263,3363,1,2,chrII,known_gene
704669,705386,717,1,2,chrII,known_gene
711590,712754,1164,1,2,chrII,known_gene
723269,723635,366,1,2,chrII,known_gene
738581,739544,963,1,2,chrII,known_gene
744851,746111,1260,1,2,chrII,known_gene
768239,768680,441,1,2,chrII,known_gene
773921,774356,435,1,2,chrII,known_gene
776570,777854,1284,1,2,chrII,known_gene
779666,782384,2718,1,2,chrII,known_gene
792848,796499,3651,1,2,chrII,known_gene
800522,801929,1407,1,2,chrII,known_gene
802630,804475,1845,-1,0,chrII,known_gene
748060,749371,1311,-1,0,chrII,known_gene
742159,742576,417,-1,0,chrII,known_gene
729733,730162,429,-1,0,chrII,known_gene
716881,717994,1113,-1,0,chrII,known_gene
702817,703204,387,-1,0,chrII,known_gene
700489,701842,1353,-1,0,chrII,known_gene
698353,699943,1590,-1,0,chrII,known_gene
690382,691693,1311,-1,0,chrII,known_gene
688105,688405,300,-1,0,chrII,novel_orf
668662,670297,1635,-1,0,chrII,known_gene
666925,667243,318,-1,0,chrII,known_gene
665152,666253,1101,-1,0,chrII,known_gene
662734,663091,357,-1,0,chrII,known_gene
616126,618523,2397,-1,0,chrII,known_gene
615202,615856,654,-1,0,chrII,known_gene
612235,613900,1665,-1,0,chrII,known_gene
599122,599959,837,-1,0,chrII,known_gene
586546,589114,2568,-1,0,chrII,known_gene
584806,586162,1356,-1,0,chrII,known_gene
582337,582652,315,-1,0,chrII,known_gene
581725,582172,447,-1,0,chrII,known_gene
576343,578086,1743,-1,0,chrII,known_gene
567874,568426,552,-1,0,chrII,known_gene
541372,541690,318,-1,0,chrII,known_gene
538666,539080,414,-1,0,chrII,novel_orf
499651,501442,1791,-1,0,chrII,known_gene
487198,488380,1182,-1,0,chrII,known_gene
484741,486691,1950,-1,0,chrII,known_gene
481363,483367,2004,-1,0,chrII,known_gene
477856,478834,978,-1,0,chrII,novel_orf
474391,476437,2046,-1,0,chrII,known_gene
469747,473926,4179,-1,0,chrII,known_gene
463951,464392,441,-1,0,chrII,known_gene
457918,458362,444,-1,0,chrII,known_gene
455359,455692,333,-1,0,chrII,novel_orf
454852,455176,324,-1,0,chrII,novel_orf
450880,451969,1089,-1,0,chrII,known_gene
429547,430951,1404,-1,0,chrII,known_gene
412564,412906,342,-1,0,chrII,novel_orf
406627,406960,333,-1,0,chrII,known_gene
393571,394150,579,-1,0,chrII,novel_orf
391804,392293,489,-1,0,chrII,known_gene
376573,378433,1860,-1,0,chrII,known_gene
370036,370699,663,-1,0,chrII,known_gene
364786,365719,933,-1,0,chrII,known_gene
356860,360187,3327,-1,0,chrII,known_gene
353671,356083,2412,-1,0,chrII,known_gene
352192,353293,1101,-1,0,chrII,known_gene
348667,348979,312,-1,0,chrII,novel_orf
338719,339352,633,-1,0,chrII,known_gene
335578,335908,330,-1,0,chrII,known_gene
324340,326059,1719,-1,0,chrII,known_gene
315592,315967,375,-1,0,chrII,novel_orf
310564,311452,888,-1,0,chrII,known_gene
306268,306955,687,-1,0,chrII,known_gene
296368,297742,1374,-1,0,chrII,known_gene
294424,296002,1578,-1,0,chrII,known_gene
292876,294019,1143,-1,0,chrII,known_gene
290680,291865,1185,-1,0,chrII,known_gene
274426,275527,1101,-1,0,chrII,known_gene
270946,273703,2757,-1,0,chrII,known_gene
270253,270598,345,-1,0,chrII,novel_orf
267709,269503,1794,-1,0,chrII,known_gene
252562,254209,1647,-1,0,chrII,known_gene
235393,235792,399,-1,0,chrII,known_gene
216586,217129,543,-1,0,chrII,known_gene
205126,205468,342,-1,0,chrII,novel_orf
199063,201748,2685,-1,0,chrII,known_gene
185317,185800,483,-1,0,chrII,novel_orf
184783,185092,309,-1,0,chrII,novel_orf
174919,177526,2607,-1,0,chrII,known_gene
160948,161305,357,-1,0,chrII,novel_orf
153847,158389,4542,-1,0,chrII,known_gene
151492,153610,2118,-1,0,chrII,known_gene
142111,142582,471,-1,0,chrII,known_gene
138340,140260,1920,-1,0,chrII,known_gene
127894,132040,4146,-1,0,chrII,known_gene
122752,124759,2007,-1,0,chrII,known_gene
90604,90925,321,-1,0,chrII,known_gene
88522,89125,603,-1,0,chrII,known_gene
80377,80731,354,-1,0,chrII,known_gene
78475,78799,324,-1,0,chrII,novel_orf
73069,74695,1626,-1,0,chrII,known_gene
69712,70138,426,-1,0,chrII,known_gene
67168,69445,2277,-1,0,chrII,known_gene
61201,62602,1401,-1,0,chrII,known_gene
59821,60169,348,-1,0,chrII,known_gene
47362,48628,1266,-1,0,chrII,known_gene
46564,46864,300,-1,0,chrII,known_gene
36988,37303,315,-1,0,chrII,known_gene
22075,23536,1461,-1,0,chrII,known_gene
10846,13879,3033,-1,0,chrII,known_gene
2581,2899,318,-1,0,chrII,known_gene
810339,811479,1140,-1,1,chrII,known_gene
808599,809097,498,-1,1,chrII,known_gene
796797,798522,1725,-1,1,chrII,known_gene
784701,785073,372,-1,1,chrII,known_gene
783672,784572,900,-1,1,chrII,known_gene
782634,782997,363,-1,1,chrII,novel_orf
778011,779463,1452,-1,1,chrII,known_gene
768942,770415,1473,-1,1,chrII,known_gene
762783,764712,1929,-1,1,chrII,known_gene
739935,740388,453,-1,1,chrII,known_gene
737769,738426,657,-1,1,chrII,known_gene
723735,724263,528,-1,1,chrII,known_gene
719979,720288,309,-1,1,chrII,novel_orf
702588,704055,1467,-1,1,chrII,known_gene
695106,697302,2196,-1,1,chrII,known_gene
685437,686592,1155,-1,1,chrII,known_gene
679548,679965,417,-1,1,chrII,known_gene
676356,679221,2865,-1,1,chrII,known_gene
662994,664677,1683,-1,1,chrII,known_gene
655575,657600,2025,-1,1,chrII,known_gene
636702,642210,5508,-1,1,chrII,known_gene
632253,633381,1128,-1,1,chrII,known_gene
627171,627696,525,-1,1,chrII,novel_orf
609081,609753,672,-1,1,chrII,known_gene
603684,604107,423,-1,1,chrII,known_gene
593505,594864,1359,-1,1,chrII,known_gene
591711,592236,525,-1,1,chrII,known_gene
571467,571890,423,-1,1,chrII,known_gene
569841,571200,1359,-1,1,chrII,known_gene
563202,564570,1368,-1,1,chrII,known_gene
553542,554310,768,-1,1,chrII,known_gene
551103,553200,2097,-1,1,chrII,known_gene
548361,549009,648,-1,1,chrII,known_gene
530868,532182,1314,-1,1,chrII,known_gene
495591,496869,1278,-1,1,chrII,known_gene
494352,495339,987,-1,1,chrII,known_gene
493080,494115,1035,-1,1,chrII,known_gene
491268,492822,1554,-1,1,chrII,known_gene
488904,490392,1488,-1,1,chrII,known_gene
483969,484560,591,-1,1,chrII,known_gene
474198,474726,528,-1,1,chrII,known_gene
453792,454530,738,-1,1,chrII,known_gene
443820,444693,873,-1,1,chrII,known_gene
442923,443307,384,-1,1,chrII,known_gene
441627,442056,429,-1,1,chrII,novel_orf
426189,426489,300,-1,1,chrII,known_gene
424989,425766,777,-1,1,chrII,known_gene
398613,400890,2277,-1,1,chrII,known_gene
395382,398277,2895,-1,1,chrII,known_gene
373860,375690,1830,-1,1,chrII,known_gene
372102,372735,633,-1,1,chrII,known_gene
368583,369678,1095,-1,1,chrII,known_gene
366969,368184,1215,-1,1,chrII,known_gene
360651,362514,1863,-1,1,chrII,known_gene
358098,358449,351,-1,1,chrII,known_gene
357297,357645,348,-1,1,chrII,known_gene
344601,347301,2700,-1,1,chrII,known_gene
337182,338199,1017,-1,1,chrII,known_gene
320415,321609,1194,-1,1,chrII,known_gene
304929,305976,1047,-1,1,chrII,known_gene
284427,287925,3498,-1,1,chrII,known_gene
276252,278352,2100,-1,1,chrII,known_gene
266724,267336,612,-1,1,chrII,known_gene
265491,265881,390,-1,1,chrII,known_gene
259146,259566,420,-1,1,chrII,known_gene
255372,255684,312,-1,1,chrII,known_gene
248805,251016,2211,-1,1,chrII,known_gene
244365,245667,1302,-1,1,chrII,known_gene
241707,242568,861,-1,1,chrII,known_gene
231648,231951,303,-1,1,chrII,novel_orf
212631,216366,3735,-1,1,chrII,known_gene
206106,206949,843,-1,1,chrII,known_gene
194940,195438,498,-1,1,chrII,novel_orf
194307,194913,606,-1,1,chrII,novel_orf
186843,191583,4740,-1,1,chrII,known_gene
185997,186306,309,-1,1,chrII,known_gene
181659,182094,435,-1,1,chrII,known_gene
177873,181275,3402,-1,1,chrII,known_gene
167517,167838,321,-1,1,chrII,known_gene
158655,159693,1038,-1,1,chrII,known_gene
143988,145728,1740,-1,1,chrII,known_gene
134142,135516,1374,-1,1,chrII,known_gene
115572,116829,1257,-1,1,chrII,known_gene
112800,113427,627,-1,1,chrII,known_gene
105315,107406,2091,-1,1,chrII,known_gene
90222,90531,309,-1,1,chrII,known_gene
86721,87789,1068,-1,1,chrII,known_gene
84498,86448,1950,-1,1,chrII,known_gene
81042,84261,3219,-1,1,chrII,known_gene
69750,71127,1377,-1,1,chrII,known_gene
51018,59382,8364,-1,1,chrII,known_gene
50349,50775,426,-1,1,chrII,novel_orf
49494,49836,342,-1,1,chrII,novel_orf
43764,44097,333,-1,1,chrII,known_gene
43173,43482,309,-1,1,chrII,known_gene
33126,33441,315,-1,1,chrII,novel_orf
24945,28299,3354,-1,1,chrII,known_gene
24258,24570,312,-1,1,chrII,novel_orf
9960,10551,591,-1,1,chrII,known_gene
279,2658,2379,-1,1,chrII,known_gene
789596,789989,393,-1,2,chrII,novel_orf
764969,767606,2637,-1,2,chrII,known_gene
760214,760616,402,-1,2,chrII,known_gene
757619,760043,2424,-1,2,chrII,known_gene
751355,757106,5751,-1,2,chrII,known_gene
746360,747803,1443,-1,2,chrII,known_gene
742760,744398,1638,-1,2,chrII,known_gene
735719,736040,321,-1,2,chrII,known_gene
734831,735530,699,-1,2,chrII,known_gene
732638,734639,2001,-1,2,chrII,known_gene
727385,728102,717,-1,2,chrII,known_gene
714806,716465,1659,-1,2,chrII,known_gene
713003,714455,1452,-1,2,chrII,known_gene
708149,711539,3390,-1,2,chrII,known_gene
705446,706793,1347,-1,2,chrII,known_gene
698624,698957,333,-1,2,chrII,known_gene
683372,683732,360,-1,2,chrII,known_gene
682178,683090,912,-1,2,chrII,known_gene
673571,675134,1563,-1,2,chrII,known_gene
673154,673565,411,-1,2,chrII,known_gene
666719,668351,1632,-1,2,chrII,known_gene
658706,662249,3543,-1,2,chrII,known_gene
654185,654548,363,-1,2,chrII,novel_orf
652685,652994,309,-1,2,chrII,novel_orf
646157,647132,975,-1,2,chrII,known_gene
610613,611882,1269,-1,2,chrII,known_gene
600557,600890,333,-1,2,chrII,novel_orf
590060,590501,441,-1,2,chrII,novel_orf
579149,581522,2373,-1,2,chrII,known_gene
573914,575996,2082,-1,2,chrII,known_gene
563849,564164,315,-1,2,chrII,known_gene
559130,559439,309,-1,2,chrII,novel_orf
541208,544493,3285,-1,2,chrII,known_gene
533234,533549,315,-1,2,chrII,known_gene
527024,528038,1014,-1,2,chrII,known_gene
517349,526628,9279,-1,2,chrII,known_gene
513761,515336,1575,-1,2,chrII,known_gene
501803,504287,2484,-1,2,chrII,known_gene
480434,480923,489,-1,2,chrII,known_gene
462869,465770,2901,-1,2,chrII,known_gene
461177,461873,696,-1,2,chrII,known_gene
445061,447323,2262,-1,2,chrII,known_gene
434405,435767,1362,-1,2,chrII,known_gene
427697,429101,1404,-1,2,chrII,known_gene
427154,427484,330,-1,2,chrII,known_gene
420200,423041,2841,-1,2,chrII,known_gene
401252,405251,3999,-1,2,chrII,known_gene
396518,396848,330,-1,2,chrII,known_gene
379220,379934,714,-1,2,chrII,known_gene
365975,366323,348,-1,2,chrII,known_gene
339674,340751,1077,-1,2,chrII,known_gene
334385,336818,2433,-1,2,chrII,known_gene
330506,331511,1005,-1,2,chrII,known_gene
328172,330092,1920,-1,2,chrII,known_gene
321875,323945,2070,-1,2,chrII,known_gene
309080,310313,1233,-1,2,chrII,known_gene
294023,294356,333,-1,2,chrII,known_gene
257111,257975,864,-1,2,chrII,known_gene
238940,241283,2343,-1,2,chrII,known_gene
237152,237467,315,-1,2,chrII,known_gene
211016,211469,453,-1,2,chrII,novel_orf
209681,210137,456,-1,2,chrII,novel_orf
203405,203807,402,-1,2,chrII,known_gene
163040,163997,957,-1,2,chrII,known_gene
150446,151220,774,-1,2,chrII,known_gene
119378,121874,2496,-1,2,chrII,known_gene
100370,101156,786,-1,2,chrII,known_gene
96668,100115,3447,-1,2,chrII,known_gene
93638,95882,2244,-1,2,chrII,known_gene
77855,78278,423,-1,2,chrII,novel_orf
72413,72893,480,-1,2,chrII,novel_orf
44255,44918,663,-1,2,chrII,known_gene
41921,42284,363,-1,2,chrII,novel_orf
41084,41480,396,-1,2,chrII,novel_orf
18176,21425,3249,-1,2,chrII,known_gene
14240,17696,3456,-1,2,chrII,known_gene
4193,5009,816,-1,2,chrII,known_gene
2906,3779,873,-1,2,chrII,known_gene
1367,2447,1080,-1,2,chrII,known_gene
2823,3750,927,1,0,chrIII,novel_orf
9705,11082,1377,1,0,chrIII,known_gene
13281,13809,528,1,0,chrIII,known_gene
17289,18561,1272,1,0,chrIII,known_gene
23526,23925,399,1,0,chrIII,known_gene
50583,50943,360,1,0,chrIII,known_gene
52644,54882,2238,1,0,chrIII,known_gene
59025,60726,1701,1,0,chrIII,known_gene
70149,71367,1218,1,0,chrIII,known_gene
71802,73341,1539,1,0,chrIII,known_gene
76998,77391,393,1,0,chrIII,novel_orf
79161,82275,3114,1,0,chrIII,known_gene
83619,83997,378,1,0,chrIII,known_gene
85101,86418,1317,1,0,chrIII,novel_orf
91323,92418,1095,1,0,chrIII,known_gene
104640,105099,459,1,0,chrIII,novel_orf
109104,110670,1566,1,0,chrIII,known_gene
111915,112482,567,1,0,chrIII,known_gene
113079,113541,462,1,0,chrIII,known_gene
128469,130281,1812,1,0,chrIII,known_gene
137745,138996,1251,1,0,chrIII,known_gene
193296,194298,1002,1,0,chrIII,known_gene
200910,201243,333,1,0,chrIII,known_gene
204294,204774,480,1,0,chrIII,novel_orf
208851,209406,555,1,0,chrIII,known_gene
216696,218241,1545,1,0,chrIII,known_gene
226890,227319,429,1,0,chrIII,known_gene
237213,238776,1563,1,0,chrIII,known_gene
244314,244755,441,1,0,chrIII,novel_orf
254370,258654,4284,1,0,chrIII,known_gene
258882,259269,387,1,0,chrIII,known_gene
263391,263964,573,1,0,chrIII,known_gene
266349,266721,372,1,0,chrIII,known_gene
280116,286443,6327,1,0,chrIII,known_gene
286761,287937,1176,1,0,chrIII,known_gene
307800,308175,375,1,0,chrIII,known_gene
309069,310155,1086,1,0,chrIII,known_gene
2125,2566,441,1,1,chrIII,known_gene
13750,14119,369,1,1,chrIII,known_gene
27928,28936,1008,1,1,chrIII,known_gene
46639,46963,324,1,1,chrIII,known_gene
47425,47872,447,1,1,chrIII,novel_orf
61657,62722,1065,1,1,chrIII,known_gene
71977,72316,339,1,1,chrIII,known_gene
84466,84787,321,1,1,chrIII,novel_orf
86374,90415,4041,1,1,chrIII,novel_orf
95356,95662,306,1,1,chrIII,novel_orf
96280,101191,4911,1,1,chrIII,known_gene
108049,108391,342,1,1,chrIII,known_gene
115684,115999,315,1,1,chrIII,known_gene
152836,153928,1092,1,1,chrIII,known_gene
190591,191635,1044,1,1,chrIII,known_gene
208750,209101,351,1,1,chrIII,known_gene
213121,213433,312,1,1,chrIII,known_gene
214993,216445,1452,1,1,chrIII,known_gene
224398,224734,336,1,1,chrIII,known_gene
225562,227458,1896,1,1,chrIII,known_gene
229309,231004,1695,1,1,chrIII,known_gene
231499,232963,1464,1,1,chrIII,known_gene
233188,233503,315,1,1,chrIII,novel_orf
234592,234892,300,1,1,chrIII,novel_orf
235462,235837,375,1,1,chrIII,novel_orf
238180,238504,324,1,1,chrIII,known_gene
252844,254173,1329,1,1,chrIII,known_gene
262915,263269,354,1,1,chrIII,known_gene
267433,272263,4830,1,1,chrIII,known_gene
279238,279598,360,1,1,chrIII,novel_orf
310957,313456,2499,1,1,chrIII,known_gene
1391,2135,744,1,2,chrIII,known_gene
7244,7619,375,1,2,chrIII,novel_orf
24767,26906,2139,1,2,chrIII,known_gene
31448,33974,2526,1,2,chrIII,known_gene
35864,37616,1752,1,2,chrIII,known_gene
42164,43556,1392,1,2,chrIII,known_gene
50837,52340,1503,1,2,chrIII,known_gene
63440,64481,1041,1,2,chrIII,known_gene
108020,108791,771,1,2,chrIII,known_gene
118619,119171,552,1,2,chrIII,known_gene
136544,136847,303,1,2,chrIII,novel_orf
143633,144506,873,1,2,chrIII,known_gene
179519,186023,6504,1,2,chrIII,known_gene
186488,190169,3681,1,2,chrIII,known_gene
192215,192629,414,1,2,chrIII,novel_orf
200441,200969,528,1,2,chrIII,known_gene
211928,213761,1833,1,2,chrIII,known_gene
214070,214739,669,1,2,chrIII,known_gene
223688,223988,300,1,2,chrIII,novel_orf
228317,228791,474,1,2,chrIII,known_gene
239054,240011,957,1,2,chrIII,known_gene
246962,247910,948,1,2,chrIII,known_gene
251195,251510,315,1,2,chrIII,novel_orf
259577,259961,384,1,2,chrIII,known_gene
263975,264491,516,1,2,chrIII,known_gene
265067,266846,1779,1,2,chrIII,known_gene
274403,276566,2163,1,2,chrIII,known_gene
313889,314981,1092,1,2,chrIII,known_gene
302481,303030,549,-1,0,chrIII,known_gene
300831,301299,468,-1,0,chrIII,known_gene
297048,298605,1557,-1,0,chrIII,known_gene
293178,293538,360,-1,0,chrIII,known_gene
270987,271395,408,-1,0,chrIII,novel_orf
260310,262452,2142,-1,0,chrIII,known_gene
253638,253947,309,-1,0,chrIII,novel_orf
240804,242352,1548,-1,0,chrIII,known_gene
240102,240543,441,-1,0,chrIII,known_gene
233124,236322,3198,-1,0,chrIII,known_gene
231756,232074,318,-1,0,chrIII,novel_orf
210717,211545,828,-1,0,chrIII,known_gene
209913,210423,510,-1,0,chrIII,known_gene
208134,209610,1476,-1,0,chrIII,known_gene
199545,200178,633,-1,0,chrIII,known_gene
160743,162222,1479,-1,0,chrIII,known_gene
156108,157107,999,-1,0,chrIII,known_gene
154011,154659,648,-1,0,chrIII,known_gene
141216,142170,954,-1,0,chrIII,known_gene
122529,123003,474,-1,0,chrIII,known_gene
120945,122328,1383,-1,0,chrIII,known_gene
119574,120318,744,-1,0,chrIII,known_gene
94620,95763,1143,-1,0,chrIII,known_gene
78948,79296,348,-1,0,chrIII,known_gene
76017,77919,1902,-1,0,chrIII,known_gene
74703,75285,582,-1,0,chrIII,known_gene
73404,73986,582,-1,0,chrIII,known_gene
68598,69921,1323,-1,0,chrIII,known_gene
64674,65568,894,-1,0,chrIII,known_gene
62775,63282,507,-1,0,chrIII,known_gene
62115,62415,300,-1,0,chrIII,novel_orf
60840,61173,333,-1,0,chrIII,known_gene
44622,46905,2283,-1,0,chrIII,known_gene
22428,23379,951,-1,0,chrIII,known_gene
11502,12285,783,-1,0,chrIII,known_gene
314351,314738,387,-1,1,chrIII,novel_orf
283391,283703,312,-1,1,chrIII,novel_orf
264005,264467,462,-1,1,chrIII,known_gene
218375,220067,1692,-1,1,chrIII,known_gene
206876,207950,1074,-1,1,chrIII,known_gene
201173,205397,4224,-1,1,chrIII,known_gene
173825,176438,2613,-1,1,chrIII,known_gene
170885,172424,1539,-1,1,chrIII,known_gene
167369,167999,630,-1,1,chrIII,known_gene
163445,163856,411,-1,1,chrIII,known_gene
158537,160373,1836,-1,1,chrIII,known_gene
142559,142874,315,-1,1,chrIII,novel_orf
139184,140933,1749,-1,1,chrIII,known_gene
138401,139049,648,-1,1,chrIII,known_gene
132272,133124,852,-1,1,chrIII,known_gene
110807,111302,495,-1,1,chrIII,known_gene
106973,107366,393,-1,1,chrIII,known_gene
105695,106853,1158,-1,1,chrIII,known_gene
104618,105548,930,-1,1,chrIII,known_gene
102074,103358,1284,-1,1,chrIII,known_gene
91985,92297,312,-1,1,chrIII,novel_orf
81569,82085,516,-1,1,chrIII,known_gene
74720,75083,363,-1,1,chrIII,known_gene
65933,68333,2400,-1,1,chrIII,known_gene
50132,50627,495,-1,1,chrIII,known_gene
39785,40724,939,-1,1,chrIII,known_gene
37835,38801,966,-1,1,chrIII,known_gene
34142,35393,1251,-1,1,chrIII,known_gene
26924,27359,435,-1,1,chrIII,known_gene
23522,23981,459,-1,1,chrIII,known_gene
18815,22106,3291,-1,1,chrIII,known_gene
15797,16880,1083,-1,1,chrIII,known_gene
304360,305467,1107,-1,2,chrIII,known_gene
301270,302221,951,-1,2,chrIII,known_gene
288169,289258,1089,-1,2,chrIII,known_gene
276763,279907,3144,-1,2,chrIII,known_gene
272314,272863,549,-1,2,chrIII,known_gene
250237,252628,2391,-1,2,chrIII,known_gene
249292,250045,753,-1,2,chrIII,known_gene
248032,248815,783,-1,2,chrIII,known_gene
246994,247315,321,-1,2,chrIII,novel_orf
242587,246583,3996,-1,2,chrIII,known_gene
228094,228505,411,-1,2,chrIII,known_gene
223453,224230,777,-1,2,chrIII,known_gene
220456,223228,2772,-1,2,chrIII,known_gene
213463,213772,309,-1,2,chrIII,known_gene
211870,212317,447,-1,2,chrIII,known_gene
206260,206644,384,-1,2,chrIII,known_gene
197620,199549,1929,-1,2,chrIII,known_gene
194413,197185,2772,-1,2,chrIII,known_gene
191833,193018,1185,-1,2,chrIII,known_gene
182755,183064,309,-1,2,chrIII,novel_orf
174697,175153,456,-1,2,chrIII,known_gene
173140,173440,300,-1,2,chrIII,known_gene
164110,166339,2229,-1,2,chrIII,known_gene
157420,157765,345,-1,2,chrIII,known_gene
148237,148903,666,-1,2,chrIII,known_gene
144772,147634,2862,-1,2,chrIII,known_gene
133723,136873,3150,-1,2,chrIII,known_gene
130744,131542,798,-1,2,chrIII,known_gene
126010,126730,720,-1,2,chrIII,known_gene
117379,118348,969,-1,2,chrIII,known_gene
103570,104350,780,-1,2,chrIII,known_gene
92776,94270,1494,-1,2,chrIII,known_gene
70789,71122,333,-1,2,chrIII,novel_orf
57373,58774,1401,-1,2,chrIII,known_gene
54940,56527,1587,-1,2,chrIII,known_gene
48652,50221,1569,-1,2,chrIII,known_gene
47110,48364,1254,-1,2,chrIII,known_gene
43660,44437,777,-1,2,chrIII,known_gene
43117,43501,384,-1,2,chrIII,novel_orf
33463,33916,453,-1,2,chrIII,novel_orf
32209,32614,405,-1,2,chrIII,novel_orf
12385,13018,633,-1,2,chrIII,known_gene
6478,8326,1848,-1,2,chrIII,known_gene
16203,17226,1023,1,0,chrIV,known_gene
20634,21006,372,1,0,chrIV,known_gene
28467,28770,303,1,0,chrIV,novel_orf
32295,33234,939,1,0,chrIV,known_gene
42699,43707,1008,1,0,chrIV,known_gene
44064,45906,1842,1,0,chrIV,known_gene
59118,59499,381,1,0,chrIV,novel_orf
62010,62562,552,1,0,chrIV,known_gene
62616,62946,330,1,0,chrIV,novel_orf
66492,67446,954,1,0,chrIV,known_gene
77583,77886,303,1,0,chrIV,novel_orf
106740,107070,330,1,0,chrIV,known_gene
111579,114234,2655,1,0,chrIV,known_gene
126786,130002,3216,1,0,chrIV,known_gene
139521,141114,1593,1,0,chrIV,known_gene
159603,160764,1161,1,0,chrIV,known_gene
162465,162840,375,1,0,chrIV,novel_orf
164289,164865,576,1,0,chrIV,known_gene
176772,178056,1284,1,0,chrIV,known_gene
183342,184611,1269,1,0,chrIV,known_gene
190107,190527,420,1,0,chrIV,novel_orf
190923,192261,1338,1,0,chrIV,known_gene
199995,201582,1587,1,0,chrIV,known_gene
216528,217074,546,1,0,chrIV,known_gene
222426,223740,1314,1,0,chrIV,known_gene
240258,241197,939,1,0,chrIV,known_gene
245922,246447,525,1,0,chrIV,known_gene
248580,251238,2658,1,0,chrIV,known_gene
251565,253746,2181,1,0,chrIV,known_gene
255603,256530,927,1,0,chrIV,known_gene
268920,269976,1056,1,0,chrIV,known_gene
272388,273597,1209,1,0,chrIV,known_gene
287058,289512,2454,1,0,chrIV,known_gene
289908,292140,2232,1,0,chrIV,known_gene
303210,304848,1638,1,0,chrIV,known_gene
324828,325140,312,1,0,chrIV,novel_orf
331023,332940,1917,1,0,chrIV,known_gene
337701,338070,369,1,0,chrIV,known_gene
363951,364779,828,1,0,chrIV,known_gene
391782,392127,345,1,0,chrIV,known_gene
397536,399129,1593,1,0,chrIV,known_gene
399624,400638,1014,1,0,chrIV,known_gene
404748,405060,312,1,0,chrIV,known_gene
413952,414888,936,1,0,chrIV,known_gene
429066,430926,1860,1,0,chrIV,known_gene
439908,440754,846,1,0,chrIV,known_gene
443028,443511,483,1,0,chrIV,known_gene
461841,462516,675,1,0,chrIV,known_gene
465918,470424,4506,1,0,chrIV,known_gene
471852,472941,1089,1,0,chrIV,known_gene
474045,475989,1944,1,0,chrIV,known_gene
481902,482247,345,1,0,chrIV,novel_orf
489507,490896,1389,1,0,chrIV,known_gene
491016,491502,486,1,0,chrIV,known_gene
495804,496134,330,1,0,chrIV,novel_orf
496980,497298,318,1,0,chrIV,novel_orf
499323,499632,309,1,0,chrIV,novel_orf
499968,500403,435,1,0,chrIV,novel_orf
501099,501414,315,1,0,chrIV,known_gene
508146,509109,963,1,0,chrIV,known_gene
539802,540414,612,1,0,chrIV,known_gene
551859,552948,1089,1,0,chrIV,known_gene
563526,564861,1335,1,0,chrIV,known_gene
565926,567555,1629,1,0,chrIV,known_gene
570648,573726,3078,1,0,chrIV,known_gene
579954,580452,498,1,0,chrIV,known_gene
580686,581784,1098,1,0,chrIV,known_gene
589983,590436,453,1,0,chrIV,novel_orf
593892,596583,2691,1,0,chrIV,known_gene
598467,599688,1221,1,0,chrIV,known_gene
600792,601809,1017,1,0,chrIV,known_gene
603063,603399,336,1,0,chrIV,known_gene
610440,611925,1485,1,0,chrIV,known_gene
612015,613251,1236,1,0,chrIV,known_gene
631281,636120,4839,1,0,chrIV,known_gene
671268,673365,2097,1,0,chrIV,known_gene
676101,677802,1701,1,0,chrIV,known_gene
685881,687840,1959,1,0,chrIV,known_gene
700314,701289,975,1,0,chrIV,known_gene
703233,704244,1011,1,0,chrIV,known_gene
709548,712995,3447,1,0,chrIV,known_gene
737094,737469,375,1,0,chrIV,novel_orf
738699,739245,546,1,0,chrIV,novel_orf
765705,766503,798,1,0,chrIV,known_gene
769524,769938,414,1,0,chrIV,known_gene
771876,775782,3906,1,0,chrIV,known_gene
781422,781950,528,1,0,chrIV,known_gene
808323,810381,2058,1,0,chrIV,known_gene
812109,812850,741,1,0,chrIV,known_gene
819432,820824,1392,1,0,chrIV,known_gene
829584,830277,693,1,0,chrIV,known_gene
848598,850200,1602,1,0,chrIV,known_gene
862053,864708,2655,1,0,chrIV,known_gene
867084,867519,435,1,0,chrIV,novel_orf
873384,877425,4041,1,0,chrIV,novel_orf
907329,909438,2109,1,0,chrIV,known_gene
910053,911301,1248,1,0,chrIV,known_gene
916485,917154,669,1,0,chrIV,known_gene
931128,933210,2082,1,0,chrIV,known_gene
946806,948456,1650,1,0,chrIV,known_gene
950562,952401,1839,1,0,chrIV,known_gene
963411,963861,450,1,0,chrIV,known_gene
965112,966489,1377,1,0,chrIV,known_gene
982734,986775,4041,1,0,chrIV,novel_orf
1000446,1000749,303,1,0,chrIV,novel_orf
1010175,1011273,1098,1,0,chrIV,known_gene
1012251,1012959,708,1,0,chrIV,known_gene
1019367,1020420,1053,1,0,chrIV,known_gene
1032435,1035063,2628,1,0,chrIV,known_gene
1038390,1038762,372,1,0,chrIV,novel_orf
1050690,1051020,330,1,0,chrIV,novel_orf
1055211,1055892,681,1,0,chrIV,known_gene
1067730,1068390,660,1,0,chrIV,known_gene
1085064,1086993,1929,1,0,chrIV,known_gene
1108701,1109847,1146,1,0,chrIV,known_gene
1110588,1111692,1104,1,0,chrIV,known_gene
1117125,1120233,3108,1,0,chrIV,known_gene
1127871,1129374,1503,1,0,chrIV,known_gene
1129587,1130823,1236,1,0,chrIV,known_gene
1131000,1133070,2070,1,0,chrIV,known_gene
1141167,1144842,3675,1,0,chrIV,known_gene
1145091,1146036,945,1,0,chrIV,known_gene
1146318,1147179,861,1,0,chrIV,known_gene
1190058,1191732,1674,1,0,chrIV,known_gene
1194597,1195032,435,1,0,chrIV,known_gene
1198227,1198635,408,1,0,chrIV,novel_orf
1206996,1208319,1323,1,0,chrIV,novel_orf
1212459,1212771,312,1,0,chrIV,novel_orf
1212993,1213614,621,1,0,chrIV,known_gene
1222758,1223331,573,1,0,chrIV,known_gene
1237683,1238004,321,1,0,chrIV,known_gene
1246083,1247982,1899,1,0,chrIV,known_gene
1252536,1254501,1965,1,0,chrIV,known_gene
1258695,1259709,1014,1,0,chrIV,known_gene
1261680,1262967,1287,1,0,chrIV,known_gene
1266294,1266795,501,1,0,chrIV,known_gene
1267470,1269402,1932,1,0,chrIV,known_gene
1272222,1272786,564,1,0,chrIV,known_gene
1274601,1276212,1611,1,0,chrIV,known_gene
1279209,1283799,4590,1,0,chrIV,known_gene
1294692,1295400,708,1,0,chrIV,known_gene
1303173,1305072,1899,1,0,chrIV,known_gene
1306266,1311675,5409,1,0,chrIV,known_gene
1320063,1321941,1878,1,0,chrIV,known_gene
1334820,1336953,2133,1,0,chrIV,known_gene
1338273,1339386,1113,1,0,chrIV,known_gene
1367484,1369386,1902,1,0,chrIV,known_gene
1383810,1384776,966,1,0,chrIV,known_gene
1386072,1386516,444,1,0,chrIV,known_gene
1388871,1393179,4308,1,0,chrIV,known_gene
1395120,1397817,2697,1,0,chrIV,known_gene
1399014,1399542,528,1,0,chrIV,known_gene
1417398,1418370,972,1,0,chrIV,known_gene
1422762,1424688,1926,1,0,chrIV,known_gene
1425648,1426512,864,1,0,chrIV,novel_orf
1451352,1452918,1566,1,0,chrIV,known_gene
1455219,1455534,315,1,0,chrIV,novel_orf
1478607,1480161,1554,1,0,chrIV,known_gene
1483140,1483476,336,1,0,chrIV,known_gene
1491093,1492413,1320,1,0,chrIV,known_gene
1494585,1495857,1272,1,0,chrIV,known_gene
1508004,1509714,1710,1,0,chrIV,known_gene
1512093,1513605,1512,1,0,chrIV,known_gene
1801,2953,1152,1,1,chrIV,known_gene
18958,19312,354,1,1,chrIV,known_gene
22822,25876,3054,1,1,chrIV,known_gene
36796,38173,1377,1,1,chrIV,known_gene
41725,42079,354,1,1,chrIV,novel_orf
52444,54100,1656,1,1,chrIV,known_gene
67096,67399,303,1,1,chrIV,known_gene
87460,87982,522,1,1,chrIV,known_gene
90175,92464,2289,1,1,chrIV,known_gene
116320,116866,546,1,1,chrIV,known_gene
122215,123589,1374,1,1,chrIV,known_gene
135895,137539,1644,1,1,chrIV,known_gene
142096,144223,2127,1,1,chrIV,known_gene
149332,149683,351,1,1,chrIV,novel_orf
149896,150211,315,1,1,chrIV,novel_orf
150277,150607,330,1,1,chrIV,novel_orf
167713,169078,1365,1,1,chrIV,known_gene
172480,174028,1548,1,1,chrIV,known_gene
178333,181039,2706,1,1,chrIV,known_gene
181828,182230,402,1,1,chrIV,novel_orf
182821,183187,366,1,1,chrIV,known_gene
184924,187918,2994,1,1,chrIV,known_gene
203038,205111,2073,1,1,chrIV,known_gene
227392,228715,1323,1,1,chrIV,known_gene
232651,233887,1236,1,1,chrIV,known_gene
241417,241840,423,1,1,chrIV,known_gene
242551,244981,2430,1,1,chrIV,known_gene
267922,268699,777,1,1,chrIV,known_gene
276871,280165,3294,1,1,chrIV,known_gene
282499,282814,315,1,1,chrIV,novel_orf
292780,293221,441,1,1,chrIV,known_gene
305236,306577,1341,1,1,chrIV,known_gene
311461,312037,576,1,1,chrIV,novel_orf
317221,317668,447,1,1,chrIV,novel_orf
333499,333829,330,1,1,chrIV,known_gene
334834,336121,1287,1,1,chrIV,known_gene
339856,340282,426,1,1,chrIV,known_gene
345664,351037,5373,1,1,chrIV,known_gene
351433,352420,987,1,1,chrIV,known_gene
352876,355378,2502,1,1,chrIV,known_gene
371239,371761,522,1,1,chrIV,known_gene
374725,375034,309,1,1,chrIV,novel_orf
382582,382891,309,1,1,chrIV,novel_orf
383500,383803,303,1,1,chrIV,novel_orf
384796,385150,354,1,1,chrIV,novel_orf
392692,393037,345,1,1,chrIV,novel_orf
394216,397204,2988,1,1,chrIV,known_gene
398617,398929,312,1,1,chrIV,known_gene
411388,411688,300,1,1,chrIV,novel_orf
427363,428347,984,1,1,chrIV,known_gene
438046,439360,1314,1,1,chrIV,known_gene
444682,446383,1701,1,1,chrIV,known_gene
455200,456583,1383,1,1,chrIV,known_gene
477796,478285,489,1,1,chrIV,known_gene
503497,503863,366,1,1,chrIV,known_gene
521815,522928,1113,1,1,chrIV,known_gene
525439,527215,1776,1,1,chrIV,known_gene
528262,528568,306,1,1,chrIV,novel_orf
529792,530308,516,1,1,chrIV,novel_orf
532147,532453,306,1,1,chrIV,novel_orf
533677,534193,516,1,1,chrIV,novel_orf
536032,536338,306,1,1,chrIV,novel_orf
537562,538078,516,1,1,chrIV,novel_orf
542845,543217,372,1,1,chrIV,novel_orf
560248,560644,396,1,1,chrIV,known_gene
573238,573709,471,1,1,chrIV,known_gene
578662,579112,450,1,1,chrIV,known_gene
592438,592948,510,1,1,chrIV,known_gene
622111,624721,2610,1,1,chrIV,known_gene
635839,636175,336,1,1,chrIV,known_gene
637138,639823,2685,1,1,chrIV,known_gene
655012,655444,432,1,1,chrIV,known_gene
667003,667858,855,1,1,chrIV,known_gene
679543,679852,309,1,1,chrIV,known_gene
682174,682492,318,1,1,chrIV,known_gene
694699,697894,3195,1,1,chrIV,known_gene
715951,716302,351,1,1,chrIV,novel_orf
734137,734803,666,1,1,chrIV,known_gene
746737,748357,1620,1,1,chrIV,known_gene
751630,753235,1605,1,1,chrIV,known_gene
769930,770332,402,1,1,chrIV,known_gene
770356,771454,1098,1,1,chrIV,known_gene
784870,786205,1335,1,1,chrIV,known_gene
789448,790069,621,1,1,chrIV,known_gene
790327,791848,1521,1,1,chrIV,known_gene
803194,804517,1323,1,1,chrIV,novel_orf
806620,807748,1128,1,1,chrIV,known_gene
811123,811513,390,1,1,chrIV,novel_orf
816877,817525,648,1,1,chrIV,known_gene
827581,829057,1476,1,1,chrIV,known_gene
851227,852397,1170,1,1,chrIV,known_gene
858136,859144,1008,1,1,chrIV,known_gene
859297,861520,2223,1,1,chrIV,known_gene
889750,892492,2742,1,1,chrIV,known_gene
900421,900871,450,1,1,chrIV,novel_orf
901690,902143,453,1,1,chrIV,novel_orf
902167,902560,393,1,1,chrIV,novel_orf
915529,915928,399,1,1,chrIV,known_gene
924784,926146,1362,1,1,chrIV,known_gene
927451,929098,1647,1,1,chrIV,known_gene
960613,963106,2493,1,1,chrIV,known_gene
993133,993952,819,1,1,chrIV,known_gene
998863,999877,1014,1,1,chrIV,known_gene
1009009,1009834,825,1,1,chrIV,known_gene
1035994,1036873,879,1,1,chrIV,known_gene
1037194,1038106,912,1,1,chrIV,known_gene
1039369,1039699,330,1,1,chrIV,known_gene
1056550,1057600,1050,1,1,chrIV,known_gene
1063351,1067425,4074,1,1,chrIV,known_gene
1075864,1077853,1989,1,1,chrIV,known_gene
1093762,1095178,1416,1,1,chrIV,known_gene
1096063,1097386,1323,1,1,chrIV,novel_orf
1102183,1103428,1245,1,1,chrIV,known_gene
1106335,1106881,546,1,1,chrIV,novel_orf
1121092,1121404,312,1,1,chrIV,novel_orf
1125301,1125628,327,1,1,chrIV,known_gene
1127074,1127584,510,1,1,chrIV,novel_orf
1134871,1135186,315,1,1,chrIV,novel_orf
1167382,1167841,459,1,1,chrIV,novel_orf
1178665,1181260,2595,1,1,chrIV,known_gene
1181800,1182754,954,1,1,chrIV,known_gene
1184746,1185889,1143,1,1,chrIV,known_gene
1199182,1200553,1371,1,1,chrIV,known_gene
1208797,1212265,3468,1,1,chrIV,novel_orf
1213903,1214842,939,1,1,chrIV,known_gene
1216795,1217113,318,1,1,chrIV,novel_orf
1226821,1228303,1482,1,1,chrIV,known_gene
1230166,1233196,3030,1,1,chrIV,known_gene
1248754,1249072,318,1,1,chrIV,novel_orf
1250185,1251634,1449,1,1,chrIV,known_gene
1270948,1272085,1137,1,1,chrIV,known_gene
1298431,1301011,2580,1,1,chrIV,known_gene
1307692,1308907,1215,1,1,chrIV,known_gene
1312039,1314892,2853,1,1,chrIV,known_gene
1324822,1325203,381,1,1,chrIV,novel_orf
1328389,1328701,312,1,1,chrIV,known_gene
1328782,1330027,1245,1,1,chrIV,known_gene
1331236,1332841,1605,1,1,chrIV,known_gene
1339675,1340719,1044,1,1,chrIV,known_gene
1342492,1344241,1749,1,1,chrIV,known_gene
1344703,1345045,342,1,1,chrIV,novel_orf
1350289,1352353,2064,1,1,chrIV,known_gene
1353724,1354633,909,1,1,chrIV,known_gene
1356064,1357369,1305,1,1,chrIV,known_gene
1362877,1364902,2025,1,1,chrIV,known_gene
1369789,1379596,9807,1,1,chrIV,known_gene
1405024,1405339,315,1,1,chrIV,novel_orf
1436929,1438015,1086,1,1,chrIV,known_gene
1468225,1468573,348,1,1,chrIV,known_gene
1470016,1470418,402,1,1,chrIV,known_gene
1498231,1499335,1104,1,1,chrIV,known_gene
1523248,1523611,363,1,1,chrIV,known_gene
1526320,1531711,5391,1,1,chrIV,known_gene
5984,7814,1830,1,2,chrIV,known_gene
30656,31829,1173,1,2,chrIV,known_gene
65393,65765,372,1,2,chrIV,known_gene
78425,79058,633,1,2,chrIV,known_gene
84269,85985,1716,1,2,chrIV,known_gene
88247,89864,1617,1,2,chrIV,known_gene
92849,93323,474,1,2,chrIV,novel_orf
94604,95786,1182,1,2,chrIV,known_gene
96272,96581,309,1,2,chrIV,novel_orf
98474,99224,750,1,2,chrIV,known_gene
99560,100421,861,1,2,chrIV,known_gene
107207,111029,3822,1,2,chrIV,known_gene
114671,115799,1128,1,2,chrIV,known_gene
125615,126449,834,1,2,chrIV,known_gene
133436,134723,1287,1,2,chrIV,known_gene
138290,139205,915,1,2,chrIV,known_gene
148190,149078,888,1,2,chrIV,known_gene
156317,157904,1587,1,2,chrIV,known_gene
161375,161780,405,1,2,chrIV,novel_orf
166955,167258,303,1,2,chrIV,known_gene
174917,176486,1569,1,2,chrIV,known_gene
192749,194225,1476,1,2,chrIV,known_gene
213350,215642,2292,1,2,chrIV,known_gene
224303,226751,2448,1,2,chrIV,known_gene
231023,231899,876,1,2,chrIV,known_gene
234926,235853,927,1,2,chrIV,known_gene
247301,247682,381,1,2,chrIV,known_gene
254024,254378,354,1,2,chrIV,novel_orf
258914,263225,4311,1,2,chrIV,known_gene
283418,284444,1026,1,2,chrIV,known_gene
296819,298274,1455,1,2,chrIV,known_gene
301412,302234,822,1,2,chrIV,known_gene
325283,325640,357,1,2,chrIV,novel_orf
326612,329567,2955,1,2,chrIV,known_gene
341618,343985,2367,1,2,chrIV,known_gene
369770,370706,936,1,2,chrIV,known_gene
378101,378455,354,1,2,chrIV,known_gene
393689,394001,312,1,2,chrIV,known_gene
411824,413000,1176,1,2,chrIV,known_gene
424208,425732,1524,1,2,chrIV,known_gene
432329,433025,696,1,2,chrIV,known_gene
433496,433994,498,1,2,chrIV,known_gene
447983,449276,1293,1,2,chrIV,known_gene
453044,453650,606,1,2,chrIV,known_gene
454121,454754,633,1,2,chrIV,known_gene
463433,464996,1563,1,2,chrIV,known_gene
473156,473783,627,1,2,chrIV,known_gene
486803,488003,1200,1,2,chrIV,known_gene
488198,488528,330,1,2,chrIV,novel_orf
504296,504665,369,1,2,chrIV,novel_orf
515849,516164,315,1,2,chrIV,novel_orf
546641,547628,987,1,2,chrIV,known_gene
553253,555152,1899,1,2,chrIV,known_gene
574163,575783,1620,1,2,chrIV,known_gene
576473,578159,1686,1,2,chrIV,known_gene
583712,584645,933,1,2,chrIV,known_gene
597155,598082,927,1,2,chrIV,known_gene
604007,606986,2979,1,2,chrIV,known_gene
614378,614705,327,1,2,chrIV,novel_orf
614816,615371,555,1,2,chrIV,novel_orf
641489,642083,594,1,2,chrIV,novel_orf
653606,654428,822,1,2,chrIV,known_gene
658349,661103,2754,1,2,chrIV,known_gene
688226,690533,2307,1,2,chrIV,known_gene
693584,694175,591,1,2,chrIV,known_gene
704483,709250,4767,1,2,chrIV,known_gene
728258,730250,1992,1,2,chrIV,known_gene
730577,732836,2259,1,2,chrIV,known_gene
749729,750338,609,1,2,chrIV,novel_orf
755627,763874,8247,1,2,chrIV,known_gene
776162,778721,2559,1,2,chrIV,known_gene
779042,780206,1164,1,2,chrIV,known_gene
804995,805688,693,1,2,chrIV,novel_orf
806747,807047,300,1,2,chrIV,known_gene
814451,816560,2109,1,2,chrIV,known_gene
817949,818495,546,1,2,chrIV,known_gene
821294,825776,4482,1,2,chrIV,known_gene
833243,833747,504,1,2,chrIV,novel_orf
836420,838061,1641,1,2,chrIV,known_gene
838391,840392,2001,1,2,chrIV,known_gene
842336,843449,1113,1,2,chrIV,known_gene
844553,844952,399,1,2,chrIV,known_gene
854174,854540,366,1,2,chrIV,known_gene
856316,856814,498,1,2,chrIV,known_gene
857681,857999,318,1,2,chrIV,known_gene
868223,870563,2340,1,2,chrIV,known_gene
872111,873428,1317,1,2,chrIV,novel_orf
884195,884552,357,1,2,chrIV,novel_orf
884726,886865,2139,1,2,chrIV,known_gene
887231,888911,1680,1,2,chrIV,known_gene
892874,893927,1053,1,2,chrIV,known_gene
895034,899006,3972,1,2,chrIV,known_gene
912098,913502,1404,1,2,chrIV,known_gene
917570,921647,4077,1,2,chrIV,known_gene
926222,926570,348,1,2,chrIV,known_gene
933503,935138,1635,1,2,chrIV,known_gene
936614,937493,879,1,2,chrIV,known_gene
952799,953981,1182,1,2,chrIV,known_gene
954287,954947,660,1,2,chrIV,known_gene
956012,957398,1386,1,2,chrIV,known_gene
981461,982778,1317,1,2,chrIV,novel_orf
1004003,1005143,1140,1,2,chrIV,known_gene
1005674,1008689,3015,1,2,chrIV,known_gene
1020746,1021664,918,1,2,chrIV,known_gene
1039727,1042961,3234,1,2,chrIV,known_gene
1059626,1061231,1605,1,2,chrIV,known_gene
1087580,1088942,1362,1,2,chrIV,known_gene
1097864,1101332,3468,1,2,chrIV,novel_orf
1104191,1104947,756,1,2,chrIV,known_gene
1135931,1140476,4545,1,2,chrIV,known_gene
1150880,1151183,303,1,2,chrIV,known_gene
1169177,1170143,966,1,2,chrIV,known_gene
1183298,1184258,960,1,2,chrIV,known_gene
1186106,1188941,2835,1,2,chrIV,known_gene
1219412,1220948,1536,1,2,chrIV,known_gene
1228610,1228916,306,1,2,chrIV,known_gene
1234217,1236125,1908,1,2,chrIV,known_gene
1239491,1239824,333,1,2,chrIV,known_gene
1243229,1245758,2529,1,2,chrIV,known_gene
1259900,1261271,1371,1,2,chrIV,known_gene
1263323,1266158,2835,1,2,chrIV,known_gene
1270067,1270733,666,1,2,chrIV,known_gene
1277645,1278437,792,1,2,chrIV,known_gene
1289405,1292120,2715,1,2,chrIV,known_gene
1301615,1302113,498,1,2,chrIV,known_gene
1322204,1323386,1182,1,2,chrIV,known_gene
1328834,1329206,372,1,2,chrIV,known_gene
1329599,1330040,441,1,2,chrIV,known_gene
1337351,1337774,423,1,2,chrIV,known_gene
1345646,1346039,393,1,2,chrIV,known_gene
1347878,1348577,699,1,2,chrIV,novel_orf
1386641,1388375,1734,1,2,chrIV,known_gene
1400138,1400453,315,1,2,chrIV,novel_orf
1403321,1404173,852,1,2,chrIV,known_gene
1412372,1414274,1902,1,2,chrIV,known_gene
1414574,1415171,597,1,2,chrIV,known_gene
1421156,1422485,1329,1,2,chrIV,known_gene
1431011,1431896,885,1,2,chrIV,known_gene
1434923,1435874,951,1,2,chrIV,known_gene
1436216,1436588,372,1,2,chrIV,known_gene
1441958,1442378,420,1,2,chrIV,novel_orf
1444124,1444427,303,1,2,chrIV,novel_orf
1447829,1450073,2244,1,2,chrIV,known_gene
1469399,1469705,306,1,2,chrIV,known_gene
1471016,1471448,432,1,2,chrIV,known_gene
1473428,1474772,1344,1,2,chrIV,known_gene
1477238,1478357,1119,1,2,chrIV,known_gene
1480424,1480832,408,1,2,chrIV,known_gene
1489904,1490234,330,1,2,chrIV,known_gene
1499420,1499720,300,1,2,chrIV,novel_orf
1510901,1511630,729,1,2,chrIV,known_gene
1530047,1530623,576,1,2,chrIV,known_gene
1530862,1531345,483,-1,0,chrIV,known_gene
1529986,1530562,576,-1,0,chrIV,novel_orf
1527478,1527829,351,-1,0,chrIV,novel_orf
1519663,1520698,1035,-1,0,chrIV,known_gene
1510855,1511461,606,-1,0,chrIV,known_gene
1503313,1504900,1587,-1,0,chrIV,known_gene
1499395,1500553,1158,-1,0,chrIV,known_gene
1496164,1496548,384,-1,0,chrIV,known_gene
1485565,1487038,1473,-1,0,chrIV,known_gene
1477561,1477861,300,-1,0,chrIV,novel_orf
1470499,1471063,564,-1,0,chrIV,known_gene
1466452,1468444,1992,-1,0,chrIV,known_gene
1462357,1465786,3429,-1,0,chrIV,known_gene
1453309,1454464,1155,-1,0,chrIV,known_gene
1445842,1446994,1152,-1,0,chrIV,known_gene
1443712,1445467,1755,-1,0,chrIV,known_gene
1441432,1443403,1971,-1,0,chrIV,known_gene
1438114,1441150,3036,-1,0,chrIV,known_gene
1434499,1434991,492,-1,0,chrIV,known_gene
1431967,1434268,2301,-1,0,chrIV,known_gene
1415209,1416874,1665,-1,0,chrIV,known_gene
1407463,1410094,2631,-1,0,chrIV,known_gene
1399705,1401214,1509,-1,0,chrIV,known_gene
1398025,1398700,675,-1,0,chrIV,known_gene
1386937,1387297,360,-1,0,chrIV,novel_orf
1361119,1362181,1062,-1,0,chrIV,known_gene
1357579,1358902,1323,-1,0,chrIV,known_gene
1345675,1349938,4263,-1,0,chrIV,known_gene
1332982,1333969,987,-1,0,chrIV,known_gene
1325500,1328470,2970,-1,0,chrIV,known_gene
1318045,1319275,1230,-1,0,chrIV,known_gene
1307422,1308610,1188,-1,0,chrIV,novel_orf
1301554,1301926,372,-1,0,chrIV,known_gene
1297036,1298161,1125,-1,0,chrIV,known_gene
1292371,1293091,720,-1,0,chrIV,known_gene
1265752,1266091,339,-1,0,chrIV,novel_orf
1264438,1264873,435,-1,0,chrIV,novel_orf
1260541,1261165,624,-1,0,chrIV,novel_orf
1241203,1242031,828,-1,0,chrIV,known_gene
1225165,1226536,1371,-1,0,chrIV,known_gene
1223473,1224394,921,-1,0,chrIV,known_gene
1202842,1204210,1368,-1,0,chrIV,known_gene
1195411,1196263,852,-1,0,chrIV,known_gene
1189198,1189567,369,-1,0,chrIV,known_gene
1186066,1186369,303,-1,0,chrIV,known_gene
1170325,1171825,1500,-1,0,chrIV,known_gene
1169527,1169854,327,-1,0,chrIV,novel_orf
1154215,1155928,1713,-1,0,chrIV,known_gene
1147378,1149466,2088,-1,0,chrIV,known_gene
1137313,1137661,348,-1,0,chrIV,novel_orf
1136590,1136926,336,-1,0,chrIV,novel_orf
1125433,1126018,585,-1,0,chrIV,known_gene
1114432,1116763,2331,-1,0,chrIV,known_gene
1112479,1114027,1548,-1,0,chrIV,known_gene
1090432,1092511,2079,-1,0,chrIV,known_gene
1079047,1080199,1152,-1,0,chrIV,known_gene
1073734,1075171,1437,-1,0,chrIV,known_gene
1045639,1049392,3753,-1,0,chrIV,known_gene
1030549,1031419,870,-1,0,chrIV,known_gene
1014400,1015702,1302,-1,0,chrIV,known_gene
1008394,1008766,372,-1,0,chrIV,known_gene
1005664,1005988,324,-1,0,chrIV,known_gene
996028,998323,2295,-1,0,chrIV,known_gene
966556,967822,1266,-1,0,chrIV,known_gene
957757,958339,582,-1,0,chrIV,known_gene
948517,950284,1767,-1,0,chrIV,known_gene
941056,943420,2364,-1,0,chrIV,known_gene
937894,940816,2922,-1,0,chrIV,known_gene
921925,923806,1881,-1,0,chrIV,known_gene
920182,920671,489,-1,0,chrIV,novel_orf
894088,894502,414,-1,0,chrIV,known_gene
882604,883927,1323,-1,0,chrIV,novel_orf
864118,864577,459,-1,0,chrIV,novel_orf
856897,857953,1056,-1,0,chrIV,known_gene
854278,856093,1815,-1,0,chrIV,known_gene
852532,853972,1440,-1,0,chrIV,known_gene
850273,850999,726,-1,0,chrIV,known_gene
843568,844861,1293,-1,0,chrIV,known_gene
838858,839209,351,-1,0,chrIV,novel_orf
836746,837091,345,-1,0,chrIV,novel_orf
836227,836746,519,-1,0,chrIV,known_gene
832858,835492,2634,-1,0,chrIV,known_gene
821593,822421,828,-1,0,chrIV,novel_orf
818707,819196,489,-1,0,chrIV,known_gene
796192,802222,6030,-1,0,chrIV,known_gene
768511,769000,489,-1,0,chrIV,known_gene
766735,767971,1236,-1,0,chrIV,known_gene
759598,759904,306,-1,0,chrIV,novel_orf
755554,756262,708,-1,0,chrIV,known_gene
748612,750742,2130,-1,0,chrIV,known_gene
744310,746101,1791,-1,0,chrIV,known_gene
729112,729415,303,-1,0,chrIV,novel_orf
720961,721297,336,-1,0,chrIV,known_gene
688495,688888,393,-1,0,chrIV,novel_orf
682723,683581,858,-1,0,chrIV,known_gene
673519,675667,2148,-1,0,chrIV,known_gene
640108,643837,3729,-1,0,chrIV,known_gene
626707,628534,1827,-1,0,chrIV,known_gene
618496,619645,1149,-1,0,chrIV,known_gene
614287,616150,1863,-1,0,chrIV,known_gene
607303,610081,2778,-1,0,chrIV,known_gene
602197,602869,672,-1,0,chrIV,known_gene
588826,589402,576,-1,0,chrIV,known_gene
584938,587719,2781,-1,0,chrIV,known_gene
582790,583465,675,-1,0,chrIV,known_gene
574489,574822,333,-1,0,chrIV,novel_orf
569233,569566,333,-1,0,chrIV,known_gene
561439,562327,888,-1,0,chrIV,known_gene
548761,550576,1815,-1,0,chrIV,known_gene
526084,526441,357,-1,0,chrIV,novel_orf
523210,524713,1503,-1,0,chrIV,known_gene
514042,518083,4041,-1,0,chrIV,novel_orf
488071,488662,591,-1,0,chrIV,known_gene
484162,485365,1203,-1,0,chrIV,known_gene
456835,457552,717,-1,0,chrIV,known_gene
441013,442309,1296,-1,0,chrIV,known_gene
432307,432631,324,-1,0,chrIV,known_gene
426001,426934,933,-1,0,chrIV,known_gene
425569,425872,303,-1,0,chrIV,known_gene
411760,412081,321,-1,0,chrIV,known_gene
405343,407206,1863,-1,0,chrIV,known_gene
400996,403291,2295,-1,0,chrIV,known_gene
376756,378445,1689,-1,0,chrIV,known_gene
375679,376480,801,-1,0,chrIV,known_gene
373966,375289,1323,-1,0,chrIV,known_gene
362671,363583,912,-1,0,chrIV,known_gene
359824,361285,1461,-1,0,chrIV,known_gene
344236,344953,717,-1,0,chrIV,known_gene
335011,335467,456,-1,0,chrIV,novel_orf
324046,326149,2103,-1,0,chrIV,known_gene
301654,302089,435,-1,0,chrIV,known_gene
295033,296329,1296,-1,0,chrIV,known_gene
280306,281848,1542,-1,0,chrIV,known_gene
273652,274876,1224,-1,0,chrIV,known_gene
264511,264964,453,-1,0,chrIV,known_gene
262435,262870,435,-1,0,chrIV,novel_orf
246688,247612,924,-1,0,chrIV,known_gene
245956,246328,372,-1,0,chrIV,novel_orf
219661,220771,1110,-1,0,chrIV,known_gene
201718,202570,852,-1,0,chrIV,known_gene
198661,199741,1080,-1,0,chrIV,known_gene
164986,167254,2268,-1,0,chrIV,known_gene
148606,149086,480,-1,0,chrIV,known_gene
145825,147589,1764,-1,0,chrIV,known_gene
141208,141721,513,-1,0,chrIV,known_gene
130870,131833,963,-1,0,chrIV,known_gene
103648,104551,903,-1,0,chrIV,known_gene
100114,100414,300,-1,0,chrIV,novel_orf
92761,93745,984,-1,0,chrIV,known_gene
86206,87226,1020,-1,0,chrIV,known_gene
70639,73918,3279,-1,0,chrIV,known_gene
60871,61801,930,-1,0,chrIV,known_gene
46270,48031,1761,-1,0,chrIV,known_gene
38866,42244,3378,-1,0,chrIV,known_gene
28984,30454,1470,-1,0,chrIV,known_gene
11656,13360,1704,-1,0,chrIV,known_gene
1530069,1530576,507,-1,1,chrIV,novel_orf
1529364,1529700,336,-1,1,chrIV,novel_orf
1524633,1524933,300,-1,1,chrIV,known_gene
1503630,1504170,540,-1,1,chrIV,known_gene
1501446,1502160,714,-1,1,chrIV,known_gene
1496790,1497768,978,-1,1,chrIV,known_gene
1487541,1488990,1449,-1,1,chrIV,known_gene
1483794,1485303,1509,-1,1,chrIV,known_gene
1427430,1428219,789,-1,1,chrIV,known_gene
1404444,1405854,1410,-1,1,chrIV,known_gene
1393335,1394574,1239,-1,1,chrIV,known_gene
1380054,1382046,1992,-1,1,chrIV,known_gene
1366263,1366827,564,-1,1,chrIV,known_gene
1363233,1363572,339,-1,1,chrIV,novel_orf
1352181,1352589,408,-1,1,chrIV,known_gene
1344516,1345062,546,-1,1,chrIV,known_gene
1342803,1343130,327,-1,1,chrIV,novel_orf
1340142,1340535,393,-1,1,chrIV,novel_orf
1324476,1325301,825,-1,1,chrIV,known_gene
1323453,1324239,786,-1,1,chrIV,known_gene
1312101,1312494,393,-1,1,chrIV,novel_orf
1276653,1277169,516,-1,1,chrIV,known_gene
1257357,1258056,699,-1,1,chrIV,known_gene
1254936,1256847,1911,-1,1,chrIV,known_gene
1248153,1249821,1668,-1,1,chrIV,known_gene
1227966,1228299,333,-1,1,chrIV,novel_orf
1221111,1222149,1038,-1,1,chrIV,known_gene
1217781,1219110,1329,-1,1,chrIV,known_gene
1215015,1217580,2565,-1,1,chrIV,known_gene
1178754,1179294,540,-1,1,chrIV,novel_orf
1172385,1174176,1791,-1,1,chrIV,known_gene
1167213,1168659,1446,-1,1,chrIV,known_gene
1162956,1164660,1704,-1,1,chrIV,known_gene
1162005,1162449,444,-1,1,chrIV,known_gene
1151802,1153626,1824,-1,1,chrIV,known_gene
1133259,1135431,2172,-1,1,chrIV,known_gene
1126269,1127595,1326,-1,1,chrIV,known_gene
1120608,1124925,4317,-1,1,chrIV,known_gene
1106094,1108101,2007,-1,1,chrIV,known_gene
1105002,1105827,825,-1,1,chrIV,known_gene
1078026,1078449,423,-1,1,chrIV,known_gene
1071879,1072557,678,-1,1,chrIV,known_gene
1058175,1058814,639,-1,1,chrIV,known_gene
1052622,1054647,2025,-1,1,chrIV,known_gene
1043145,1045011,1866,-1,1,chrIV,known_gene
1038279,1039509,1230,-1,1,chrIV,known_gene
1023510,1024755,1245,-1,1,chrIV,known_gene
1017000,1017318,318,-1,1,chrIV,known_gene
1011588,1011960,372,-1,1,chrIV,known_gene
991026,992349,1323,-1,1,chrIV,novel_orf
977520,979209,1689,-1,1,chrIV,known_gene
976716,977229,513,-1,1,chrIV,known_gene
958680,959802,1122,-1,1,chrIV,known_gene
935235,935892,657,-1,1,chrIV,known_gene
929469,930357,888,-1,1,chrIV,known_gene
926292,926910,618,-1,1,chrIV,known_gene
914316,914712,396,-1,1,chrIV,known_gene
905454,906852,1398,-1,1,chrIV,known_gene
903780,905052,1272,-1,1,chrIV,known_gene
899550,903480,3930,-1,1,chrIV,known_gene
891228,891579,351,-1,1,chrIV,novel_orf
878658,882126,3468,-1,1,chrIV,novel_orf
871035,871449,414,-1,1,chrIV,known_gene
865011,867522,2511,-1,1,chrIV,known_gene
843810,844281,471,-1,1,chrIV,known_gene
840603,841995,1392,-1,1,chrIV,known_gene
831933,832473,540,-1,1,chrIV,known_gene
830628,831513,885,-1,1,chrIV,known_gene
825909,827355,1446,-1,1,chrIV,known_gene
813192,814152,960,-1,1,chrIV,known_gene
810564,811632,1068,-1,1,chrIV,known_gene
801549,801972,423,-1,1,chrIV,known_gene
790506,790854,348,-1,1,chrIV,novel_orf
785763,786102,339,-1,1,chrIV,novel_orf
785022,785364,342,-1,1,chrIV,novel_orf
782040,784215,2175,-1,1,chrIV,known_gene
768402,768753,351,-1,1,chrIV,known_gene
742041,743874,1833,-1,1,chrIV,known_gene
740472,741600,1128,-1,1,chrIV,known_gene
727710,728283,573,-1,1,chrIV,known_gene
723003,727551,4548,-1,1,chrIV,known_gene
718815,720303,1488,-1,1,chrIV,known_gene
715746,716622,876,-1,1,chrIV,known_gene
698553,699468,915,-1,1,chrIV,known_gene
691548,693261,1713,-1,1,chrIV,known_gene
678240,679764,1524,-1,1,chrIV,known_gene
669015,671034,2019,-1,1,chrIV,known_gene
667824,668139,315,-1,1,chrIV,novel_orf
649803,651126,1323,-1,1,chrIV,novel_orf
638385,638703,318,-1,1,chrIV,novel_orf
625065,625998,933,-1,1,chrIV,known_gene
622545,623139,594,-1,1,chrIV,novel_orf
617469,618306,837,-1,1,chrIV,known_gene
613404,614004,600,-1,1,chrIV,known_gene
581907,582498,591,-1,1,chrIV,known_gene
558510,560625,2115,-1,1,chrIV,known_gene
557055,558060,1005,-1,1,chrIV,known_gene
553083,553398,315,-1,1,chrIV,known_gene
547977,548310,333,-1,1,chrIV,known_gene
542673,543369,696,-1,1,chrIV,known_gene
540600,541203,603,-1,1,chrIV,known_gene
535191,538467,3276,-1,1,chrIV,known_gene
531306,534582,3276,-1,1,chrIV,known_gene
527421,530697,3276,-1,1,chrIV,known_gene
509736,512109,2373,-1,1,chrIV,known_gene
503568,503895,327,-1,1,chrIV,novel_orf
492555,494268,1713,-1,1,chrIV,known_gene
485745,486444,699,-1,1,chrIV,known_gene
458541,461247,2706,-1,1,chrIV,known_gene
450219,452475,2256,-1,1,chrIV,known_gene
432924,433248,324,-1,1,chrIV,known_gene
422832,423510,678,-1,1,chrIV,known_gene
408450,409857,1407,-1,1,chrIV,known_gene
392658,393912,1254,-1,1,chrIV,known_gene
384600,385587,987,-1,1,chrIV,known_gene
381984,384081,2097,-1,1,chrIV,known_gene
378873,381438,2565,-1,1,chrIV,known_gene
372687,373608,921,-1,1,chrIV,known_gene
366738,368211,1473,-1,1,chrIV,known_gene
365067,365874,807,-1,1,chrIV,known_gene
361698,362256,558,-1,1,chrIV,known_gene
349749,350247,498,-1,1,chrIV,novel_orf
338271,340134,1863,-1,1,chrIV,known_gene
333120,333822,702,-1,1,chrIV,known_gene
329835,330447,612,-1,1,chrIV,known_gene
320667,321552,885,-1,1,chrIV,known_gene
314253,314748,495,-1,1,chrIV,known_gene
310641,312471,1830,-1,1,chrIV,known_gene
309801,310122,321,-1,1,chrIV,known_gene
300213,300999,786,-1,1,chrIV,known_gene
298416,300003,1587,-1,1,chrIV,known_gene
293391,294759,1368,-1,1,chrIV,known_gene
285390,286695,1305,-1,1,chrIV,known_gene
284580,285165,585,-1,1,chrIV,known_gene
282111,283176,1065,-1,1,chrIV,known_gene
265257,267201,1944,-1,1,chrIV,known_gene
256632,258555,1923,-1,1,chrIV,known_gene
218679,219288,609,-1,1,chrIV,known_gene
211374,212118,744,-1,1,chrIV,known_gene
205359,210561,5202,-1,1,chrIV,known_gene
184956,185382,426,-1,1,chrIV,novel_orf
181185,183018,1833,-1,1,chrIV,known_gene
174231,174588,357,-1,1,chrIV,known_gene
173865,174174,309,-1,1,chrIV,known_gene
170409,171930,1521,-1,1,chrIV,known_gene
167358,167715,357,-1,1,chrIV,known_gene
149202,155640,6438,-1,1,chrIV,known_gene
144483,145518,1035,-1,1,chrIV,known_gene
126834,127242,408,-1,1,chrIV,known_gene
125508,125838,330,-1,1,chrIV,known_gene
123864,124998,1134,-1,1,chrIV,known_gene
104916,106494,1578,-1,1,chrIV,known_gene
101289,103353,2064,-1,1,chrIV,known_gene
100500,101121,621,-1,1,chrIV,known_gene
96081,97953,1872,-1,1,chrIV,known_gene
79293,80412,1119,-1,1,chrIV,known_gene
74445,76545,2100,-1,1,chrIV,known_gene
57264,60405,3141,-1,1,chrIV,known_gene
54396,56346,1950,-1,1,chrIV,known_gene
51114,52173,1059,-1,1,chrIV,known_gene
45276,45918,642,-1,1,chrIV,known_gene
34236,36477,2241,-1,1,chrIV,known_gene
33414,33918,504,-1,1,chrIV,known_gene
24885,25197,312,-1,1,chrIV,novel_orf
8682,9756,1074,-1,1,chrIV,known_gene
1525094,1525523,429,-1,2,chrIV,known_gene
1517135,1517675,540,-1,2,chrIV,known_gene
1497086,1497395,309,-1,2,chrIV,known_gene
1491074,1491545,471,-1,2,chrIV,known_gene
1481084,1483403,2319,-1,2,chrIV,known_gene
1474973,1476476,1503,-1,2,chrIV,known_gene
1471547,1472999,1452,-1,2,chrIV,known_gene
1459727,1461554,1827,-1,2,chrIV,known_gene
1456694,1459220,2526,-1,2,chrIV,known_gene
1456310,1456694,384,-1,2,chrIV,known_gene
1455041,1455866,825,-1,2,chrIV,known_gene
1443755,1444070,315,-1,2,chrIV,known_gene
1429187,1430789,1602,-1,2,chrIV,known_gene
1428353,1428980,627,-1,2,chrIV,known_gene
1424819,1427252,2433,-1,2,chrIV,known_gene
1420430,1420838,408,-1,2,chrIV,known_gene
1418549,1420250,1701,-1,2,chrIV,known_gene
1410452,1411127,675,-1,2,chrIV,known_gene
1397582,1397909,327,-1,2,chrIV,known_gene
1395857,1396217,360,-1,2,chrIV,novel_orf
1391573,1392305,732,-1,2,chrIV,novel_orf
1384214,1384655,441,-1,2,chrIV,novel_orf
1382318,1383443,1125,-1,2,chrIV,known_gene
1367372,1367681,309,-1,2,chrIV,known_gene
1365071,1365662,591,-1,2,chrIV,known_gene
1321628,1322006,378,-1,2,chrIV,known_gene
1315325,1317917,2592,-1,2,chrIV,known_gene
1306328,1306628,300,-1,2,chrIV,novel_orf
1301723,1302062,339,-1,2,chrIV,known_gene
1295597,1296686,1089,-1,2,chrIV,known_gene
1294835,1295411,576,-1,2,chrIV,known_gene
1293368,1294394,1026,-1,2,chrIV,known_gene
1288214,1288859,645,-1,2,chrIV,known_gene
1284068,1287938,3870,-1,2,chrIV,known_gene
1272233,1273703,1470,-1,2,chrIV,known_gene
1266365,1266779,414,-1,2,chrIV,known_gene
1258808,1259258,450,-1,2,chrIV,novel_orf
1256060,1256402,342,-1,2,chrIV,known_gene
1239959,1240718,759,-1,2,chrIV,known_gene
1229348,1229720,372,-1,2,chrIV,known_gene
1212437,1212836,399,-1,2,chrIV,known_gene
1204496,1206383,1887,-1,2,chrIV,known_gene
1196678,1198697,2019,-1,2,chrIV,known_gene
1191935,1194884,2949,-1,2,chrIV,known_gene
1176119,1178174,2055,-1,2,chrIV,known_gene
1159607,1161320,1713,-1,2,chrIV,known_gene
1149950,1150520,570,-1,2,chrIV,known_gene
1128740,1129082,342,-1,2,chrIV,novel_orf
1128296,1128596,300,-1,2,chrIV,novel_orf
1118423,1119113,690,-1,2,chrIV,novel_orf
1092740,1093586,846,-1,2,chrIV,known_gene
1089218,1090079,861,-1,2,chrIV,known_gene
1081127,1084316,3189,-1,2,chrIV,known_gene
1072745,1073207,462,-1,2,chrIV,known_gene
1068728,1071386,2658,-1,2,chrIV,known_gene
1061504,1062791,1287,-1,2,chrIV,known_gene
1050458,1052228,1770,-1,2,chrIV,known_gene
1035230,1035575,345,-1,2,chrIV,known_gene
1025069,1030049,4980,-1,2,chrIV,known_gene
1022006,1022321,315,-1,2,chrIV,known_gene
1002509,1003502,993,-1,2,chrIV,known_gene
1000103,1002023,1920,-1,2,chrIV,known_gene
994241,995534,1293,-1,2,chrIV,known_gene
987533,990548,3015,-1,2,chrIV,novel_orf
984653,984968,315,-1,2,chrIV,novel_orf
974630,975782,1152,-1,2,chrIV,known_gene
971807,974243,2436,-1,2,chrIV,known_gene
969989,971474,1485,-1,2,chrIV,known_gene
968132,969680,1548,-1,2,chrIV,known_gene
963989,964565,576,-1,2,chrIV,known_gene
943673,945152,1479,-1,2,chrIV,known_gene
875303,875618,315,-1,2,chrIV,novel_orf
866696,867086,390,-1,2,chrIV,known_gene
866024,866381,357,-1,2,chrIV,known_gene
849116,849713,597,-1,2,chrIV,novel_orf
845951,847946,1995,-1,2,chrIV,known_gene
806936,807344,408,-1,2,chrIV,novel_orf
792347,793889,1542,-1,2,chrIV,known_gene
786305,789221,2916,-1,2,chrIV,known_gene
780389,781100,711,-1,2,chrIV,known_gene
764177,765155,978,-1,2,chrIV,known_gene
753674,755066,1392,-1,2,chrIV,known_gene
743057,743444,387,-1,2,chrIV,known_gene
734900,739997,5097,-1,2,chrIV,known_gene
716789,718460,1671,-1,2,chrIV,known_gene
713339,714233,894,-1,2,chrIV,known_gene
701396,702758,1362,-1,2,chrIV,known_gene
700586,700970,384,-1,2,chrIV,novel_orf
683945,685643,1698,-1,2,chrIV,known_gene
681923,682226,303,-1,2,chrIV,known_gene
680495,681617,1122,-1,2,chrIV,known_gene
665348,666770,1422,-1,2,chrIV,known_gene
661172,664910,3738,-1,2,chrIV,known_gene
657647,657980,333,-1,2,chrIV,known_gene
655685,657467,1782,-1,2,chrIV,known_gene
645857,649325,3468,-1,2,chrIV,novel_orf
644177,645035,858,-1,2,chrIV,known_gene
636116,636527,411,-1,2,chrIV,known_gene
634499,634820,321,-1,2,chrIV,novel_orf
589760,591344,1584,-1,2,chrIV,known_gene
567722,568703,981,-1,2,chrIV,known_gene
565022,565640,618,-1,2,chrIV,known_gene
563960,564272,312,-1,2,chrIV,novel_orf
563648,563960,312,-1,2,chrIV,novel_orf
555725,556472,747,-1,2,chrIV,known_gene
552479,552779,300,-1,2,chrIV,novel_orf
536843,537203,360,-1,2,chrIV,known_gene
532958,533318,360,-1,2,chrIV,known_gene
529073,529433,360,-1,2,chrIV,known_gene
518039,519356,1317,-1,2,chrIV,novel_orf
504098,504695,597,-1,2,chrIV,known_gene
501752,503273,1521,-1,2,chrIV,known_gene
497834,500879,3045,-1,2,chrIV,known_gene
494648,497318,2670,-1,2,chrIV,known_gene
482669,483860,1191,-1,2,chrIV,known_gene
479114,482267,3153,-1,2,chrIV,known_gene
465050,465383,333,-1,2,chrIV,known_gene
462251,462602,351,-1,2,chrIV,known_gene
446966,447578,612,-1,2,chrIV,known_gene
417662,421514,3852,-1,2,chrIV,known_gene
415112,416708,1596,-1,2,chrIV,known_gene
403694,404957,1263,-1,2,chrIV,known_gene
400121,400571,450,-1,2,chrIV,novel_orf
389171,392057,2886,-1,2,chrIV,known_gene
387512,388901,1389,-1,2,chrIV,known_gene
384818,385346,528,-1,2,chrIV,known_gene
370361,370676,315,-1,2,chrIV,novel_orf
364445,364817,372,-1,2,chrIV,known_gene
355673,356759,1086,-1,2,chrIV,known_gene
336248,337301,1053,-1,2,chrIV,known_gene
330665,331040,375,-1,2,chrIV,known_gene
316970,320120,3150,-1,2,chrIV,known_gene
315356,316388,1032,-1,2,chrIV,known_gene
312950,314078,1128,-1,2,chrIV,known_gene
289571,290081,510,-1,2,chrIV,known_gene
286997,287324,327,-1,2,chrIV,known_gene
275147,276581,1434,-1,2,chrIV,known_gene
270221,271901,1680,-1,2,chrIV,known_gene
263312,264110,798,-1,2,chrIV,known_gene
253994,254717,723,-1,2,chrIV,known_gene
250580,250916,336,-1,2,chrIV,novel_orf
245132,245582,450,-1,2,chrIV,known_gene
236156,238664,2508,-1,2,chrIV,known_gene
205151,206060,909,-1,2,chrIV,known_gene
200045,200354,309,-1,2,chrIV,novel_orf
194570,198176,3606,-1,2,chrIV,known_gene
188153,190586,2433,-1,2,chrIV,known_gene
183317,183899,582,-1,2,chrIV,known_gene
163448,164042,594,-1,2,chrIV,known_gene
160994,163154,2160,-1,2,chrIV,known_gene
159557,159857,300,-1,2,chrIV,novel_orf
158063,158735,672,-1,2,chrIV,known_gene
118706,121592,2886,-1,2,chrIV,known_gene
77288,77966,678,-1,2,chrIV,known_gene
68996,70364,1368,-1,2,chrIV,known_gene
67982,68606,624,-1,2,chrIV,known_gene
62243,65018,2775,-1,2,chrIV,known_gene
61115,61463,348,-1,2,chrIV,known_gene
58286,58631,345,-1,2,chrIV,known_gene
57311,57665,354,-1,2,chrIV,known_gene
26402,28775,2373,-1,2,chrIV,known_gene
17576,18566,990,-1,2,chrIV,known_gene
1398,2073,675,1,0,chrV,novel_orf
2442,2778,336,1,0,chrV,novel_orf
4332,4641,309,1,0,chrV,novel_orf
4869,5481,612,1,0,chrV,known_gene
13719,14415,696,1,0,chrV,known_gene
40149,40542,393,1,0,chrV,novel_orf
42651,42960,309,1,0,chrV,known_gene
43251,44925,1674,1,0,chrV,known_gene
49221,49731,510,1,0,chrV,novel_orf
58377,59148,771,1,0,chrV,known_gene
69756,70257,501,1,0,chrV,known_gene
73770,75327,1557,1,0,chrV,known_gene
86178,86598,420,1,0,chrV,known_gene
98667,99129,462,1,0,chrV,known_gene
107259,107907,648,1,0,chrV,known_gene
111420,115800,4380,1,0,chrV,known_gene
116166,116970,804,1,0,chrV,known_gene
121470,122310,840,1,0,chrV,known_gene
123876,124185,309,1,0,chrV,known_gene
133119,135234,2115,1,0,chrV,known_gene
136278,136629,351,1,0,chrV,known_gene
139380,139752,372,1,0,chrV,novel_orf
140511,140892,381,1,0,chrV,known_gene
141891,143892,2001,1,0,chrV,known_gene
148227,148599,372,1,0,chrV,known_gene
153519,155808,2289,1,0,chrV,known_gene
159579,160275,696,1,0,chrV,known_gene
164526,166083,1557,1,0,chrV,known_gene
177834,178431,597,1,0,chrV,known_gene
196947,198519,1572,1,0,chrV,known_gene
201075,201936,861,1,0,chrV,known_gene
202191,204963,2772,1,0,chrV,known_gene
219732,220065,333,1,0,chrV,novel_orf
225888,226854,966,1,0,chrV,known_gene
228450,228831,381,1,0,chrV,known_gene
229794,231987,2193,1,0,chrV,known_gene
234936,235491,555,1,0,chrV,known_gene
243699,244029,330,1,0,chrV,known_gene
251727,253662,1935,1,0,chrV,known_gene
254655,256134,1479,1,0,chrV,known_gene
271767,272091,324,1,0,chrV,known_gene
274566,276153,1587,1,0,chrV,known_gene
278850,279219,369,1,0,chrV,novel_orf
281709,282366,657,1,0,chrV,known_gene
290241,290799,558,1,0,chrV,known_gene
292065,292551,486,1,0,chrV,known_gene
293049,294813,1764,1,0,chrV,known_gene
302805,303195,390,1,0,chrV,known_gene
304029,305592,1563,1,0,chrV,known_gene
313389,313737,348,1,0,chrV,known_gene
319962,321846,1884,1,0,chrV,known_gene
327597,328110,513,1,0,chrV,known_gene
328476,330207,1731,1,0,chrV,known_gene
343725,344028,303,1,0,chrV,novel_orf
344409,344901,492,1,0,chrV,novel_orf
363099,363702,603,1,0,chrV,known_gene
366801,367428,627,1,0,chrV,known_gene
387231,387795,564,1,0,chrV,known_gene
397305,397653,348,1,0,chrV,known_gene
413664,414084,420,1,0,chrV,novel_orf
414480,415554,1074,1,0,chrV,known_gene
423951,424311,360,1,0,chrV,known_gene
437190,437532,342,1,0,chrV,known_gene
456318,457605,1287,1,0,chrV,known_gene
468369,468816,447,1,0,chrV,known_gene
473484,474051,567,1,0,chrV,known_gene
510372,512106,1734,1,0,chrV,known_gene
523368,525759,2391,1,0,chrV,known_gene
534741,535116,375,1,0,chrV,novel_orf
541689,545055,3366,1,0,chrV,known_gene
545610,546414,804,1,0,chrV,known_gene
546747,548079,1332,1,0,chrV,known_gene
566229,566655,426,1,0,chrV,known_gene
571479,576525,5046,1,0,chrV,known_gene
16354,17845,1491,1,1,chrV,known_gene
19588,21097,1509,1,1,chrV,known_gene
41584,41917,333,1,1,chrV,novel_orf
47167,48373,1206,1,1,chrV,known_gene
63727,64090,363,1,1,chrV,known_gene
70477,73348,2871,1,1,chrV,known_gene
75943,77431,1488,1,1,chrV,known_gene
78052,79456,1404,1,1,chrV,known_gene
80419,81145,726,1,1,chrV,known_gene
85675,86149,474,1,1,chrV,known_gene
100768,101251,483,1,1,chrV,known_gene
126628,128284,1656,1,1,chrV,known_gene
128824,130561,1737,1,1,chrV,known_gene
146950,147979,1029,1,1,chrV,known_gene
156802,157498,696,1,1,chrV,known_gene
160549,162442,1893,1,1,chrV,known_gene
172114,172492,378,1,1,chrV,known_gene
178840,182278,3438,1,1,chrV,known_gene
182599,184219,1620,1,1,chrV,known_gene
184540,186775,2235,1,1,chrV,known_gene
192796,194230,1434,1,1,chrV,known_gene
198811,200875,2064,1,1,chrV,known_gene
213415,213898,483,1,1,chrV,known_gene
214915,217693,2778,1,1,chrV,known_gene
221845,222403,558,1,1,chrV,known_gene
267778,268090,312,1,1,chrV,novel_orf
272623,273886,1263,1,1,chrV,known_gene
276571,278164,1593,1,1,chrV,known_gene
318919,319552,633,1,1,chrV,known_gene
327064,327451,387,1,1,chrV,known_gene
337948,339472,1524,1,1,chrV,known_gene
351697,353236,1539,1,1,chrV,known_gene
355465,357730,2265,1,1,chrV,known_gene
364588,366517,1929,1,1,chrV,known_gene
372325,373234,909,1,1,chrV,known_gene
384691,385003,312,1,1,chrV,novel_orf
401134,401869,735,1,1,chrV,known_gene
404812,406387,1575,1,1,chrV,known_gene
410188,412618,2430,1,1,chrV,known_gene
415858,416470,612,1,1,chrV,known_gene
417280,420709,3429,1,1,chrV,known_gene
439615,440971,1356,1,1,chrV,known_gene
441574,441880,306,1,1,chrV,known_gene
451564,453235,1671,1,1,chrV,known_gene
454567,454870,303,1,1,chrV,known_gene
455179,455536,357,1,1,chrV,novel_orf
460945,461575,630,1,1,chrV,novel_orf
472942,473296,354,1,1,chrV,novel_orf
483400,483718,318,1,1,chrV,novel_orf
501661,502042,381,1,1,chrV,novel_orf
512743,517459,4716,1,1,chrV,known_gene
518215,520771,2556,1,1,chrV,known_gene
525973,526651,678,1,1,chrV,known_gene
536299,538279,1980,1,1,chrV,known_gene
548845,549517,672,1,1,chrV,known_gene
559453,560365,912,1,1,chrV,known_gene
568039,568759,720,1,1,chrV,known_gene
574864,575440,576,1,1,chrV,known_gene
629,1112,483,1,2,chrV,known_gene
1412,2156,744,1,2,chrV,novel_orf
6125,6464,339,1,2,chrV,known_gene
26666,27206,540,1,2,chrV,known_gene
27656,29543,1887,1,2,chrV,known_gene
33026,33395,369,1,2,chrV,novel_orf
34379,36254,1875,1,2,chrV,known_gene
52907,53255,348,1,2,chrV,known_gene
56570,58100,1530,1,2,chrV,known_gene
73007,73313,306,1,2,chrV,known_gene
78719,79061,342,1,2,chrV,known_gene
86936,89852,2916,1,2,chrV,known_gene
90257,93905,3648,1,2,chrV,known_gene
94643,96578,1935,1,2,chrV,known_gene
101942,102323,381,1,2,chrV,known_gene
123656,124670,1014,1,2,chrV,known_gene
131930,132551,621,1,2,chrV,known_gene
144326,145334,1008,1,2,chrV,known_gene
162722,164285,1563,1,2,chrV,known_gene
175247,176012,765,1,2,chrV,known_gene
188276,189311,1035,1,2,chrV,known_gene
195167,196517,1350,1,2,chrV,known_gene
205250,206834,1584,1,2,chrV,known_gene
222638,223076,438,1,2,chrV,known_gene
232460,234740,2280,1,2,chrV,known_gene
243179,243611,432,1,2,chrV,known_gene
295409,298001,2592,1,2,chrV,known_gene
298949,301616,2667,1,2,chrV,known_gene
314582,314984,402,1,2,chrV,novel_orf
322685,324095,1410,1,2,chrV,known_gene
330575,332306,1731,1,2,chrV,known_gene
333203,333713,510,1,2,chrV,novel_orf
342854,343232,378,1,2,chrV,known_gene
349979,351182,1203,1,2,chrV,known_gene
355139,355469,330,1,2,chrV,known_gene
359561,360314,753,1,2,chrV,known_gene
374393,374714,321,1,2,chrV,known_gene
382643,382988,345,1,2,chrV,novel_orf
391694,391997,303,1,2,chrV,novel_orf
393086,393407,321,1,2,chrV,novel_orf
402374,402719,345,1,2,chrV,known_gene
408209,408563,354,1,2,chrV,novel_orf
433529,433958,429,1,2,chrV,known_gene
453458,454919,1461,1,2,chrV,known_gene
465302,466025,723,1,2,chrV,known_gene
466184,466763,579,1,2,chrV,known_gene
475019,476228,1209,1,2,chrV,known_gene
484787,487193,2406,1,2,chrV,known_gene
501059,501452,393,1,2,chrV,novel_orf
505391,509798,4407,1,2,chrV,known_gene
527081,529418,2337,1,2,chrV,known_gene
552524,553259,735,1,2,chrV,known_gene
571154,571523,369,1,2,chrV,known_gene
566233,566560,327,-1,0,chrV,novel_orf
553333,553969,636,-1,0,chrV,known_gene
528127,528535,408,-1,0,chrV,novel_orf
512626,512983,357,-1,0,chrV,known_gene
503083,503782,699,-1,0,chrV,known_gene
500629,502894,2265,-1,0,chrV,known_gene
496801,498124,1323,-1,0,chrV,novel_orf
476344,482848,6504,-1,0,chrV,known_gene
474040,474805,765,-1,0,chrV,known_gene
466207,467470,1263,-1,0,chrV,known_gene
465202,465613,411,-1,0,chrV,known_gene
462967,464842,1875,-1,0,chrV,known_gene
462385,462823,438,-1,0,chrV,known_gene
460525,461740,1215,-1,0,chrV,known_gene
450562,451243,681,-1,0,chrV,known_gene
443755,447223,3468,-1,0,chrV,novel_orf
437266,437803,537,-1,0,chrV,known_gene
421114,422446,1332,-1,0,chrV,known_gene
407341,409063,1722,-1,0,chrV,known_gene
401224,401716,492,-1,0,chrV,known_gene
397951,399055,1104,-1,0,chrV,known_gene
395347,396172,825,-1,0,chrV,known_gene
394291,394867,576,-1,0,chrV,known_gene
390589,393712,3123,-1,0,chrV,known_gene
387931,390052,2121,-1,0,chrV,known_gene
382594,385876,3282,-1,0,chrV,known_gene
377188,377614,426,-1,0,chrV,novel_orf
375214,376999,1785,-1,0,chrV,novel_orf
373447,374545,1098,-1,0,chrV,known_gene
367837,372013,4176,-1,0,chrV,known_gene
335695,336019,324,-1,0,chrV,known_gene
333175,335188,2013,-1,0,chrV,known_gene
331816,332368,552,-1,0,chrV,known_gene
326173,327097,924,-1,0,chrV,known_gene
324271,325936,1665,-1,0,chrV,known_gene
314533,316600,2067,-1,0,chrV,known_gene
312589,313498,909,-1,0,chrV,known_gene
295300,295732,432,-1,0,chrV,known_gene
270736,271126,390,-1,0,chrV,known_gene
262051,263698,1647,-1,0,chrV,known_gene
258736,259639,903,-1,0,chrV,known_gene
240031,241501,1470,-1,0,chrV,known_gene
234094,234571,477,-1,0,chrV,novel_orf
223366,225199,1833,-1,0,chrV,known_gene
218056,221287,3231,-1,0,chrV,known_gene
214075,214747,672,-1,0,chrV,known_gene
210691,211876,1185,-1,0,chrV,known_gene
208978,210232,1254,-1,0,chrV,known_gene
207643,208474,831,-1,0,chrV,known_gene
195310,195646,336,-1,0,chrV,novel_orf
189502,191788,2286,-1,0,chrV,known_gene
183730,184063,333,-1,0,chrV,known_gene
175471,175885,414,-1,0,chrV,novel_orf
172633,173338,705,-1,0,chrV,known_gene
157735,158878,1143,-1,0,chrV,known_gene
145906,146755,849,-1,0,chrV,known_gene
132067,132505,438,-1,0,chrV,novel_orf
128302,128608,306,-1,0,chrV,known_gene
102580,106147,3567,-1,0,chrV,known_gene
94582,94897,315,-1,0,chrV,known_gene
91015,91360,345,-1,0,chrV,novel_orf
88048,88393,345,-1,0,chrV,novel_orf
87694,88012,318,-1,0,chrV,novel_orf
85612,86215,603,-1,0,chrV,known_gene
81406,82603,1197,-1,0,chrV,known_gene
80536,80881,345,-1,0,chrV,novel_orf
78682,79096,414,-1,0,chrV,novel_orf
68839,69265,426,-1,0,chrV,known_gene
64708,65167,459,-1,0,chrV,known_gene
52720,53218,498,-1,0,chrV,known_gene
45019,45721,702,-1,0,chrV,known_gene
40045,41953,1908,-1,0,chrV,known_gene
31693,33466,1773,-1,0,chrV,known_gene
28159,28654,495,-1,0,chrV,novel_orf
26188,26776,588,-1,0,chrV,known_gene
25645,25978,333,-1,0,chrV,known_gene
5344,5713,369,-1,0,chrV,known_gene
1351,2095,744,-1,0,chrV,known_gene
575679,576162,483,-1,1,chrV,known_gene
574803,575379,576,-1,1,chrV,known_gene
572295,572646,351,-1,1,chrV,novel_orf
569607,569907,300,-1,1,chrV,known_gene
551472,551796,324,-1,1,chrV,known_gene
549723,550527,804,-1,1,chrV,known_gene
539463,540363,900,-1,1,chrV,known_gene
536274,536655,381,-1,1,chrV,known_gene
521028,522669,1641,-1,1,chrV,known_gene
510726,511179,453,-1,1,chrV,novel_orf
492855,496323,3468,-1,1,chrV,novel_orf
491529,491958,429,-1,1,chrV,known_gene
488856,490578,1722,-1,1,chrV,known_gene
483324,484341,1017,-1,1,chrV,known_gene
472656,473988,1332,-1,1,chrV,known_gene
455145,456036,891,-1,1,chrV,known_gene
441372,441819,447,-1,1,chrV,known_gene
425187,430449,5262,-1,1,chrV,known_gene
418101,418605,504,-1,1,chrV,novel_orf
402870,404352,1482,-1,1,chrV,known_gene
400866,401238,372,-1,1,chrV,known_gene
399495,400842,1347,-1,1,chrV,known_gene
360501,361794,1293,-1,1,chrV,known_gene
358104,359061,957,-1,1,chrV,known_gene
327618,328140,522,-1,1,chrV,known_gene
316806,318342,1536,-1,1,chrV,known_gene
308412,311199,2787,-1,1,chrV,known_gene
292239,292563,324,-1,1,chrV,known_gene
291702,292203,501,-1,1,chrV,known_gene
285240,286914,1674,-1,1,chrV,known_gene
266511,268113,1602,-1,1,chrV,known_gene
264891,265785,894,-1,1,chrV,known_gene
256374,257958,1584,-1,1,chrV,known_gene
246981,248157,1176,-1,1,chrV,known_gene
226857,228252,1395,-1,1,chrV,known_gene
215859,216180,321,-1,1,chrV,novel_orf
212586,213177,591,-1,1,chrV,known_gene
199299,199713,414,-1,1,chrV,novel_orf
191958,192624,666,-1,1,chrV,known_gene
164343,164661,318,-1,1,chrV,known_gene
150300,150978,678,-1,1,chrV,known_gene
127803,128130,327,-1,1,chrV,novel_orf
127356,127740,384,-1,1,chrV,novel_orf
85044,85545,501,-1,1,chrV,known_gene
83049,84552,1503,-1,1,chrV,known_gene
79635,79977,342,-1,1,chrV,known_gene
71427,71799,372,-1,1,chrV,novel_orf
36534,39651,3117,-1,1,chrV,known_gene
29796,31239,1443,-1,1,chrV,known_gene
4083,4599,516,-1,1,chrV,known_gene
574886,575393,507,-1,2,chrV,known_gene
574181,574517,336,-1,2,chrV,novel_orf
561704,562625,921,-1,2,chrV,known_gene
556295,558680,2385,-1,2,chrV,known_gene
538433,539168,735,-1,2,chrV,known_gene
529529,536021,6492,-1,2,chrV,known_gene
499346,500348,1002,-1,2,chrV,known_gene
494660,495053,393,-1,2,chrV,novel_orf
469685,472424,2739,-1,2,chrV,known_gene
457805,460223,2418,-1,2,chrV,known_gene
447701,449024,1323,-1,2,chrV,novel_orf
437951,438344,393,-1,2,chrV,known_gene
414929,415277,348,-1,2,chrV,novel_orf
413393,414179,786,-1,2,chrV,known_gene
401501,401804,303,-1,2,chrV,novel_orf
378761,382103,3342,-1,2,chrV,known_gene
348728,349346,618,-1,2,chrV,known_gene
343319,347612,4293,-1,2,chrV,known_gene
339863,342167,2304,-1,2,chrV,known_gene
335945,337340,1395,-1,2,chrV,known_gene
319901,320240,339,-1,2,chrV,known_gene
301946,302327,381,-1,2,chrV,known_gene
282704,284222,1518,-1,2,chrV,known_gene
279929,280682,753,-1,2,chrV,known_gene
278297,279626,1329,-1,2,chrV,known_gene
253970,254579,609,-1,2,chrV,known_gene
243809,246503,2694,-1,2,chrV,known_gene
237569,238016,447,-1,2,chrV,known_gene
235769,237119,1350,-1,2,chrV,known_gene
230438,231035,597,-1,2,chrV,novel_orf
228455,229205,750,-1,2,chrV,known_gene
167807,171818,4011,-1,2,chrV,known_gene
148721,150014,1293,-1,2,chrV,known_gene
138917,139763,846,-1,2,chrV,known_gene
136370,136778,408,-1,2,chrV,known_gene
124736,126218,1482,-1,2,chrV,known_gene
121454,121988,534,-1,2,chrV,known_gene
120497,121301,804,-1,2,chrV,known_gene
118616,120299,1683,-1,2,chrV,known_gene
116201,116678,477,-1,2,chrV,novel_orf
113021,113405,384,-1,2,chrV,novel_orf
112634,112979,345,-1,2,chrV,novel_orf
108503,110552,2049,-1,2,chrV,known_gene
96857,97796,939,-1,2,chrV,known_gene
67628,68792,1164,-1,2,chrV,known_gene
65384,66797,1413,-1,2,chrV,known_gene
59669,60851,1182,-1,2,chrV,known_gene
53900,56102,2202,-1,2,chrV,known_gene
48470,51539,3069,-1,2,chrV,known_gene
21536,23231,1695,-1,2,chrV,known_gene
7229,7553,324,-1,2,chrV,known_gene
4463,5114,651,-1,2,chrV,known_gene
263,4097,3834,-1,2,chrV,known_gene
1632,1968,336,1,0,chrVI,novel_orf
14574,14970,396,1,0,chrVI,novel_orf
46737,47067,330,1,0,chrVI,novel_orf
74871,75192,321,1,0,chrVI,known_gene
76830,77988,1158,1,0,chrVI,known_gene
109809,110184,375,1,0,chrVI,known_gene
110646,111093,447,1,0,chrVI,known_gene
112344,113985,1641,1,0,chrVI,known_gene
139476,143517,4041,1,0,chrVI,novel_orf
149109,149724,615,1,0,chrVI,known_gene
150015,152535,2520,1,0,chrVI,known_gene
156144,157752,1608,1,0,chrVI,known_gene
165066,166566,1500,1,0,chrVI,known_gene
178002,178413,411,1,0,chrVI,novel_orf
179943,180396,453,1,0,chrVI,novel_orf
182307,182664,357,1,0,chrVI,novel_orf
183021,183321,300,1,0,chrVI,novel_orf
194811,196314,1503,1,0,chrVI,known_gene
210936,212973,2037,1,0,chrVI,known_gene
217320,217644,324,1,0,chrVI,novel_orf
224382,224730,348,1,0,chrVI,novel_orf
226962,227337,375,1,0,chrVI,known_gene
227517,227856,339,1,0,chrVI,known_gene
240282,240597,315,1,0,chrVI,novel_orf
244323,244713,390,1,0,chrVI,novel_orf
252504,253329,825,1,0,chrVI,known_gene
52,535,483,1,1,chrVI,known_gene
835,1363,528,1,1,chrVI,known_gene
5065,5521,456,1,1,chrVI,known_gene
9544,10222,678,1,1,chrVI,known_gene
11362,12259,897,1,1,chrVI,known_gene
12928,13951,1023,1,1,chrVI,known_gene
23422,25198,1776,1,1,chrVI,known_gene
28231,29629,1398,1,1,chrVI,known_gene
36802,38674,1872,1,1,chrVI,known_gene
40420,42565,2145,1,1,chrVI,known_gene
42814,43438,624,1,1,chrVI,known_gene
43684,44053,369,1,1,chrVI,novel_orf
49138,51007,1869,1,1,chrVI,known_gene
51349,52972,1623,1,1,chrVI,known_gene
56335,57709,1374,1,1,chrVI,known_gene
65476,68698,3222,1,1,chrVI,known_gene
69523,70054,531,1,1,chrVI,novel_orf
75178,75871,693,1,1,chrVI,known_gene
80764,81115,351,1,1,chrVI,novel_orf
82579,83875,1296,1,1,chrVI,known_gene
90985,93376,2391,1,1,chrVI,known_gene
95965,97498,1533,1,1,chrVI,known_gene
106414,106732,318,1,1,chrVI,known_gene
119428,123106,3678,1,1,chrVI,known_gene
123478,129910,6432,1,1,chrVI,known_gene
130333,130981,648,1,1,chrVI,known_gene
131809,134296,2487,1,1,chrVI,known_gene
136081,136453,372,1,1,chrVI,novel_orf
145726,146026,300,1,1,chrVI,novel_orf
147130,148459,1329,1,1,chrVI,known_gene
159298,160360,1062,1,1,chrVI,known_gene
160534,161200,666,1,1,chrVI,known_gene
162487,164746,2259,1,1,chrVI,known_gene
167887,168496,609,1,1,chrVI,known_gene
169921,172285,2364,1,1,chrVI,known_gene
184501,191338,6837,1,1,chrVI,known_gene
192736,193435,699,1,1,chrVI,known_gene
199873,201709,1836,1,1,chrVI,known_gene
207451,208297,846,1,1,chrVI,known_gene
234241,237250,3009,1,1,chrVI,known_gene
240475,240775,300,1,1,chrVI,novel_orf
246145,248134,1989,1,1,chrVI,known_gene
821,1280,459,1,2,chrVI,known_gene
6425,7565,1140,1,2,chrVI,known_gene
17003,18680,1677,1,2,chrVI,known_gene
24569,24911,342,1,2,chrVI,known_gene
58781,62837,4056,1,2,chrVI,known_gene
107255,107585,330,1,2,chrVI,known_gene
107798,108602,804,1,2,chrVI,known_gene
109211,109514,303,1,2,chrVI,novel_orf
116144,118484,2340,1,2,chrVI,known_gene
138203,139520,1317,1,2,chrVI,novel_orf
153392,154313,921,1,2,chrVI,known_gene
168866,169310,444,1,2,chrVI,known_gene
182234,182651,417,1,2,chrVI,novel_orf
196832,199034,2202,1,2,chrVI,known_gene
209894,210194,300,1,2,chrVI,novel_orf
213311,216419,3108,1,2,chrVI,known_gene
225050,225803,753,1,2,chrVI,novel_orf
227450,228101,651,1,2,chrVI,known_gene
229379,231941,2562,1,2,chrVI,known_gene
238457,239060,603,1,2,chrVI,known_gene
242141,242999,858,1,2,chrVI,known_gene
248522,248894,372,1,2,chrVI,known_gene
250499,250820,321,1,2,chrVI,novel_orf
264203,265226,1023,1,2,chrVI,known_gene
269060,269516,456,1,2,chrVI,known_gene
258854,259433,579,-1,0,chrVI,known_gene
249065,249866,801,-1,0,chrVI,known_gene
222089,222959,870,-1,0,chrVI,known_gene
216593,220106,3513,-1,0,chrVI,known_gene
212210,212642,432,-1,0,chrVI,novel_orf
208412,210068,1656,-1,0,chrVI,known_gene
201959,203081,1122,-1,0,chrVI,known_gene
182273,182861,588,-1,0,chrVI,known_gene
177041,180743,3702,-1,0,chrVI,known_gene
166745,167258,513,-1,0,chrVI,known_gene
154526,155873,1347,-1,0,chrVI,known_gene
151634,151970,336,-1,0,chrVI,novel_orf
141395,141710,315,-1,0,chrVI,novel_orf
105569,105947,378,-1,0,chrVI,known_gene
103982,104462,480,-1,0,chrVI,known_gene
101627,103127,1500,-1,0,chrVI,known_gene
99230,99599,369,-1,0,chrVI,known_gene
79343,80213,870,-1,0,chrVI,known_gene
45719,47744,2025,-1,0,chrVI,known_gene
44654,45560,906,-1,0,chrVI,known_gene
20846,22787,1941,-1,0,chrVI,known_gene
14792,15431,639,-1,0,chrVI,novel_orf
3029,3338,309,-1,0,chrVI,known_gene
1436,2615,1179,-1,0,chrVI,known_gene
263956,264325,369,-1,1,chrVI,known_gene
253591,255049,1458,-1,1,chrVI,known_gene
250162,251803,1641,-1,1,chrVI,known_gene
243073,244159,1086,-1,1,chrVI,known_gene
239113,239827,714,-1,1,chrVI,known_gene
237367,238255,888,-1,1,chrVI,known_gene
230407,230800,393,-1,1,chrVI,novel_orf
227512,229186,1674,-1,1,chrVI,known_gene
226120,226465,345,-1,1,chrVI,known_gene
225019,225958,939,-1,1,chrVI,known_gene
214753,215146,393,-1,1,chrVI,novel_orf
207856,208261,405,-1,1,chrVI,novel_orf
205747,206257,510,-1,1,chrVI,known_gene
202060,202654,594,-1,1,chrVI,known_gene
185197,185503,306,-1,1,chrVI,novel_orf
184759,185065,306,-1,1,chrVI,novel_orf
183130,184222,1092,-1,1,chrVI,known_gene
152656,153124,468,-1,1,chrVI,known_gene
107851,109930,2079,-1,1,chrVI,known_gene
106468,106963,495,-1,1,chrVI,known_gene
46426,46735,309,-1,1,chrVI,known_gene
43627,44392,765,-1,1,chrVI,known_gene
38842,40180,1338,-1,1,chrVI,known_gene
33271,35848,2577,-1,1,chrVI,known_gene
10300,10969,669,-1,1,chrVI,known_gene
253428,253734,306,-1,2,chrVI,known_gene
251049,251487,438,-1,2,chrVI,known_gene
247512,248058,546,-1,2,chrVI,novel_orf
244278,245166,888,-1,2,chrVI,known_gene
239991,241437,1446,-1,2,chrVI,known_gene
232011,233544,1533,-1,2,chrVI,known_gene
224325,224769,444,-1,2,chrVI,known_gene
203742,204750,1008,-1,2,chrVI,known_gene
187068,187419,351,-1,2,chrVI,novel_orf
174264,176391,2127,-1,2,chrVI,known_gene
172536,173877,1341,-1,2,chrVI,known_gene
170115,170652,537,-1,2,chrVI,novel_orf
145113,146934,1821,-1,2,chrVI,known_gene
134520,137157,2637,-1,2,chrVI,known_gene
132498,132852,354,-1,2,chrVI,novel_orf
132009,132411,402,-1,2,chrVI,novel_orf
115107,115743,636,-1,2,chrVI,known_gene
104700,106236,1536,-1,2,chrVI,known_gene
100251,100605,354,-1,2,chrVI,known_gene
96642,97026,384,-1,2,chrVI,novel_orf
95760,96615,855,-1,2,chrVI,known_gene
93498,95010,1512,-1,2,chrVI,known_gene
87846,90345,2499,-1,2,chrVI,known_gene
84144,87234,3090,-1,2,chrVI,known_gene
80418,81912,1494,-1,2,chrVI,known_gene
78054,79161,1107,-1,2,chrVI,known_gene
69114,74427,5313,-1,2,chrVI,known_gene
63015,63795,780,-1,2,chrVI,known_gene
55365,55986,621,-1,2,chrVI,known_gene
53259,54342,1083,-1,2,chrVI,known_gene
52584,52995,411,-1,2,chrVI,novel_orf
34824,35133,309,-1,2,chrVI,known_gene
30057,30540,483,-1,2,chrVI,known_gene
14304,14763,459,-1,2,chrVI,novel_orf
3321,3846,525,-1,2,chrVI,known_gene
774,1302,528,-1,2,chrVI,novel_orf
8469,8967,498,1,0,chrVII,known_gene
11109,11730,621,1,0,chrVII,known_gene
23934,25395,1461,1,0,chrVII,known_gene
35652,36762,1110,1,0,chrVII,known_gene
45444,48459,3015,1,0,chrVII,known_gene
48513,49365,852,1,0,chrVII,known_gene
49551,52434,2883,1,0,chrVII,known_gene
55278,55815,537,1,0,chrVII,known_gene
56481,58890,2409,1,0,chrVII,known_gene
59121,61854,2733,1,0,chrVII,known_gene
76893,77907,1014,1,0,chrVII,known_gene
83649,84300,651,1,0,chrVII,known_gene
90009,90495,486,1,0,chrVII,known_gene
91431,92382,951,1,0,chrVII,known_gene
92511,93591,1080,1,0,chrVII,known_gene
116058,117561,1503,1,0,chrVII,known_gene
129882,131169,1287,1,0,chrVII,known_gene
142245,144048,1803,1,0,chrVII,known_gene
144807,145197,390,1,0,chrVII,known_gene
145824,146265,441,1,0,chrVII,novel_orf
157905,159096,1191,1,0,chrVII,known_gene
168066,170571,2505,1,0,chrVII,known_gene
180699,182118,1419,1,0,chrVII,known_gene
199248,199587,339,1,0,chrVII,novel_orf
214080,215211,1131,1,0,chrVII,known_gene
226398,227529,1131,1,0,chrVII,known_gene
245715,248124,2409,1,0,chrVII,known_gene
250497,252738,2241,1,0,chrVII,known_gene
254640,255294,654,1,0,chrVII,known_gene
257706,261501,3795,1,0,chrVII,known_gene
261579,261915,336,1,0,chrVII,known_gene
270996,272139,1143,1,0,chrVII,known_gene
292032,293001,969,1,0,chrVII,known_gene
312192,312840,648,1,0,chrVII,known_gene
313233,314283,1050,1,0,chrVII,known_gene
337905,341859,3954,1,0,chrVII,known_gene
347118,349368,2250,1,0,chrVII,known_gene
358635,359028,393,1,0,chrVII,known_gene
396129,396495,366,1,0,chrVII,novel_orf
402588,403302,714,1,0,chrVII,known_gene
403686,404391,705,1,0,chrVII,known_gene
408888,409257,369,1,0,chrVII,novel_orf
418824,419289,465,1,0,chrVII,known_gene
423960,425007,1047,1,0,chrVII,known_gene
449787,450123,336,1,0,chrVII,known_gene
452403,454560,2157,1,0,chrVII,known_gene
466140,468807,2667,1,0,chrVII,known_gene
472854,474276,1422,1,0,chrVII,known_gene
512496,512823,327,1,0,chrVII,known_gene
516942,520863,3921,1,0,chrVII,known_gene
525228,526644,1416,1,0,chrVII,known_gene
527631,528504,873,1,0,chrVII,known_gene
529263,530919,1656,1,0,chrVII,known_gene
532638,532941,303,1,0,chrVII,known_gene
542202,543291,1089,1,0,chrVII,known_gene
574887,575199,312,1,0,chrVII,known_gene
575397,576504,1107,1,0,chrVII,known_gene
593595,594705,1110,1,0,chrVII,known_gene
606135,607143,1008,1,0,chrVII,known_gene
610563,611493,930,1,0,chrVII,known_gene
640719,641832,1113,1,0,chrVII,known_gene
642009,643008,999,1,0,chrVII,known_gene
644043,644595,552,1,0,chrVII,known_gene
654600,656322,1722,1,0,chrVII,known_gene
676620,677565,945,1,0,chrVII,known_gene
685599,685911,312,1,0,chrVII,novel_orf
701277,701583,306,1,0,chrVII,novel_orf
702666,703116,450,1,0,chrVII,known_gene
703635,705051,1416,1,0,chrVII,known_gene
708555,712254,3699,1,0,chrVII,novel_orf
715827,717030,1203,1,0,chrVII,known_gene
717357,718527,1170,1,0,chrVII,known_gene
720408,724764,4356,1,0,chrVII,known_gene
728253,728586,333,1,0,chrVII,novel_orf
750399,751047,648,1,0,chrVII,known_gene
754725,755250,525,1,0,chrVII,known_gene
759648,759960,312,1,0,chrVII,known_gene
761391,762168,777,1,0,chrVII,known_gene
770568,771972,1404,1,0,chrVII,known_gene
786108,786438,330,1,0,chrVII,novel_orf
789030,790329,1299,1,0,chrVII,known_gene
807072,807684,612,1,0,chrVII,known_gene
811737,813054,1317,1,0,chrVII,novel_orf
824058,826917,2859,1,0,chrVII,known_gene
828624,828960,336,1,0,chrVII,known_gene
830514,832197,1683,1,0,chrVII,known_gene
832455,833157,702,1,0,chrVII,known_gene
837141,840558,3417,1,0,chrVII,known_gene
869220,869598,378,1,0,chrVII,known_gene
876981,877347,366,1,0,chrVII,novel_orf
880419,882231,1812,1,0,chrVII,known_gene
897501,899781,2280,1,0,chrVII,known_gene
910431,910737,306,1,0,chrVII,known_gene
915240,916701,1461,1,0,chrVII,known_gene
945144,946374,1230,1,0,chrVII,known_gene
978306,978828,522,1,0,chrVII,novel_orf
982545,982986,441,1,0,chrVII,novel_orf
985971,986739,768,1,0,chrVII,known_gene
1000926,1002240,1314,1,0,chrVII,known_gene
1021647,1022058,411,1,0,chrVII,known_gene
1022655,1024761,2106,1,0,chrVII,known_gene
1031790,1037694,5904,1,0,chrVII,known_gene
1046730,1048464,1734,1,0,chrVII,known_gene
1052823,1057257,4434,1,0,chrVII,known_gene
1070292,1071714,1422,1,0,chrVII,known_gene
1076598,1078353,1755,1,0,chrVII,known_gene
5311,5839,528,1,1,chrVII,known_gene
20977,22108,1131,1,1,chrVII,known_gene
22303,23203,900,1,1,chrVII,known_gene
31897,32635,738,1,1,chrVII,known_gene
33097,35212,2115,1,1,chrVII,known_gene
38974,41149,2175,1,1,chrVII,known_gene
41497,43174,1677,1,1,chrVII,known_gene
43306,44509,1203,1,1,chrVII,known_gene
67597,69331,1734,1,1,chrVII,known_gene
69670,72547,2877,1,1,chrVII,known_gene
73339,73711,372,1,1,chrVII,known_gene
95857,97006,1149,1,1,chrVII,known_gene
98968,102076,3108,1,1,chrVII,known_gene
108157,110404,2247,1,1,chrVII,known_gene
112885,113233,348,1,1,chrVII,novel_orf
131524,139543,8019,1,1,chrVII,known_gene
154714,155179,465,1,1,chrVII,novel_orf
174544,175345,801,1,1,chrVII,known_gene
182389,184084,1695,1,1,chrVII,known_gene
186058,187339,1281,1,1,chrVII,known_gene
191128,191806,678,1,1,chrVII,known_gene
200560,202273,1713,1,1,chrVII,known_gene
202720,203833,1113,1,1,chrVII,known_gene
209005,210049,1044,1,1,chrVII,known_gene
210415,213667,3252,1,1,chrVII,known_gene
223708,224098,390,1,1,chrVII,novel_orf
224590,224965,375,1,1,chrVII,novel_orf
225571,225877,306,1,1,chrVII,known_gene
229351,229660,309,1,1,chrVII,novel_orf
230242,232348,2106,1,1,chrVII,known_gene
264856,265156,300,1,1,chrVII,novel_orf
288511,289309,798,1,1,chrVII,known_gene
299977,301369,1392,1,1,chrVII,known_gene
306559,307009,450,1,1,chrVII,known_gene
309208,309751,543,1,1,chrVII,novel_orf
317341,318079,738,1,1,chrVII,known_gene
321781,323230,1449,1,1,chrVII,known_gene
325330,326161,831,1,1,chrVII,known_gene
334885,337639,2754,1,1,chrVII,known_gene
343318,344584,1266,1,1,chrVII,known_gene
345835,346201,366,1,1,chrVII,known_gene
349615,350440,825,1,1,chrVII,known_gene
357376,358339,963,1,1,chrVII,known_gene
359443,360100,657,1,1,chrVII,known_gene
368752,371254,2502,1,1,chrVII,known_gene
377608,379582,1974,1,1,chrVII,known_gene
382276,382669,393,1,1,chrVII,novel_orf
383653,384766,1113,1,1,chrVII,known_gene
385195,388732,3537,1,1,chrVII,known_gene
389971,391990,2019,1,1,chrVII,known_gene
393985,394504,519,1,1,chrVII,known_gene
405775,406597,822,1,1,chrVII,known_gene
440062,440425,363,1,1,chrVII,known_gene
458155,458992,837,1,1,chrVII,known_gene
459853,461365,1512,1,1,chrVII,known_gene
461665,464911,3246,1,1,chrVII,known_gene
483259,483637,378,1,1,chrVII,known_gene
485920,489442,3522,1,1,chrVII,known_gene
500131,502366,2235,1,1,chrVII,known_gene
506968,507940,972,1,1,chrVII,known_gene
523786,524680,894,1,1,chrVII,known_gene
532984,533821,837,1,1,chrVII,known_gene
536056,537379,1323,1,1,chrVII,novel_orf
548263,553951,5688,1,1,chrVII,known_gene
570901,571216,315,1,1,chrVII,novel_orf
577486,579130,1644,1,1,chrVII,known_gene
579475,580291,816,1,1,chrVII,known_gene
589825,590911,1086,1,1,chrVII,known_gene
591313,591877,564,1,1,chrVII,known_gene
596692,598621,1929,1,1,chrVII,known_gene
599416,601141,1725,1,1,chrVII,known_gene
601660,604447,2787,1,1,chrVII,known_gene
617620,617989,369,1,1,chrVII,known_gene
624103,624442,339,1,1,chrVII,novel_orf
627082,627418,336,1,1,chrVII,known_gene
627805,631273,3468,1,1,chrVII,known_gene
634303,635467,1164,1,1,chrVII,known_gene
646108,646486,378,1,1,chrVII,novel_orf
656959,659770,2811,1,1,chrVII,known_gene
666340,667825,1485,1,1,chrVII,known_gene
668188,669907,1719,1,1,chrVII,known_gene
670387,671911,1524,1,1,chrVII,known_gene
678694,682135,3441,1,1,chrVII,known_gene
687898,689965,2067,1,1,chrVII,known_gene
690244,693097,2853,1,1,chrVII,known_gene
695416,697234,1818,1,1,chrVII,known_gene
742324,745435,3111,1,1,chrVII,known_gene
745834,746527,693,1,1,chrVII,known_gene
746797,747736,939,1,1,chrVII,known_gene
756895,757447,552,1,1,chrVII,known_gene
762427,763153,726,1,1,chrVII,known_gene
767428,770299,2871,1,1,chrVII,known_gene
772453,773686,1233,1,1,chrVII,known_gene
775192,777508,2316,1,1,chrVII,known_gene
779071,779422,351,1,1,chrVII,novel_orf
790849,791488,639,1,1,chrVII,novel_orf
800545,801823,1278,1,1,chrVII,known_gene
813010,817051,4041,1,1,chrVII,novel_orf
824131,824461,330,1,1,chrVII,known_gene
827551,828577,1026,1,1,chrVII,known_gene
843853,844960,1107,1,1,chrVII,known_gene
848719,849067,348,1,1,chrVII,known_gene
851851,852226,375,1,1,chrVII,novel_orf
858286,858604,318,1,1,chrVII,known_gene
865189,865495,306,1,1,chrVII,novel_orf
873706,874033,327,1,1,chrVII,novel_orf
885034,885427,393,1,1,chrVII,novel_orf
905236,905683,447,1,1,chrVII,known_gene
922174,922507,333,1,1,chrVII,known_gene
936034,936376,342,1,1,chrVII,known_gene
939922,940804,882,1,1,chrVII,known_gene
942805,944647,1842,1,1,chrVII,known_gene
947419,948997,1578,1,1,chrVII,known_gene
949519,949867,348,1,1,chrVII,known_gene
953959,954646,687,1,1,chrVII,known_gene
963670,964186,516,1,1,chrVII,novel_orf
972637,973003,366,1,1,chrVII,novel_orf
976414,976723,309,1,1,chrVII,known_gene
977335,977776,441,1,1,chrVII,known_gene
979918,980476,558,1,1,chrVII,novel_orf
988048,989419,1371,1,1,chrVII,known_gene
995638,996229,591,1,1,chrVII,known_gene
996868,998188,1320,1,1,chrVII,known_gene
1004623,1006102,1479,1,1,chrVII,known_gene
1027369,1031509,4140,1,1,chrVII,known_gene
1043188,1043749,561,1,1,chrVII,known_gene
1085203,1090591,5388,1,1,chrVII,known_gene
2789,3932,1143,1,2,chrVII,known_gene
14909,16307,1398,1,2,chrVII,known_gene
36932,37526,594,1,2,chrVII,known_gene
62555,63002,447,1,2,chrVII,known_gene
82373,82736,363,1,2,chrVII,known_gene
84884,87302,2418,1,2,chrVII,known_gene
87980,89339,1359,1,2,chrVII,known_gene
93791,94460,669,1,2,chrVII,known_gene
95357,95708,351,1,2,chrVII,novel_orf
97337,98585,1248,1,2,chrVII,known_gene
114353,114659,306,1,2,chrVII,novel_orf
118013,118340,327,1,2,chrVII,novel_orf
119510,119825,315,1,2,chrVII,novel_orf
122954,123299,345,1,2,chrVII,novel_orf
123590,124298,708,1,2,chrVII,known_gene
124697,129161,4464,1,2,chrVII,known_gene
160064,162758,2694,1,2,chrVII,known_gene
164321,164699,378,1,2,chrVII,novel_orf
167558,167906,348,1,2,chrVII,known_gene
187463,187796,333,1,2,chrVII,known_gene
188627,188930,303,1,2,chrVII,novel_orf
189326,189728,402,1,2,chrVII,novel_orf
192143,192512,369,1,2,chrVII,novel_orf
198137,199037,900,1,2,chrVII,known_gene
207032,208571,1539,1,2,chrVII,known_gene
216272,217298,1026,1,2,chrVII,known_gene
217523,220922,3399,1,2,chrVII,known_gene
223463,223772,309,1,2,chrVII,novel_orf
238352,241085,2733,1,2,chrVII,known_gene
255662,256964,1302,1,2,chrVII,known_gene
266144,267524,1380,1,2,chrVII,known_gene
272519,274322,1803,1,2,chrVII,known_gene
277616,278381,765,1,2,chrVII,known_gene
284441,285947,1506,1,2,chrVII,known_gene
289808,291641,1833,1,2,chrVII,known_gene
293459,295637,2178,1,2,chrVII,known_gene
295931,297938,2007,1,2,chrVII,known_gene
303512,303836,324,1,2,chrVII,known_gene
307436,308567,1131,1,2,chrVII,known_gene
311576,311927,351,1,2,chrVII,known_gene
314630,316553,1923,1,2,chrVII,known_gene
342671,342983,312,1,2,chrVII,novel_orf
353057,355472,2415,1,2,chrVII,known_gene
355826,356972,1146,1,2,chrVII,known_gene
372011,374084,2073,1,2,chrVII,known_gene
375086,375671,585,1,2,chrVII,known_gene
376100,377255,1155,1,2,chrVII,known_gene
392222,393698,1476,1,2,chrVII,known_gene
396716,397046,330,1,2,chrVII,novel_orf
397937,398282,345,1,2,chrVII,novel_orf
398627,400160,1533,1,2,chrVII,known_gene
403436,403742,306,1,2,chrVII,known_gene
411551,412160,609,1,2,chrVII,known_gene
414101,415730,1629,1,2,chrVII,known_gene
417482,418412,930,1,2,chrVII,known_gene
428600,431330,2730,1,2,chrVII,known_gene
449360,449666,306,1,2,chrVII,novel_orf
451265,451841,576,1,2,chrVII,novel_orf
454784,457067,2283,1,2,chrVII,known_gene
475544,476069,525,1,2,chrVII,known_gene
481319,481688,369,1,2,chrVII,novel_orf
481811,482210,399,1,2,chrVII,novel_orf
494516,495167,651,1,2,chrVII,known_gene
502937,504326,1389,1,2,chrVII,known_gene
506069,506825,756,1,2,chrVII,known_gene
511544,512732,1188,1,2,chrVII,known_gene
513158,514340,1182,1,2,chrVII,known_gene
514553,516416,1863,1,2,chrVII,known_gene
522260,522833,573,1,2,chrVII,known_gene
537857,541325,3468,1,2,chrVII,novel_orf
543851,544205,354,1,2,chrVII,known_gene
546440,547469,1029,1,2,chrVII,known_gene
560681,561350,669,1,2,chrVII,known_gene
584894,586052,1158,1,2,chrVII,known_gene
607562,609101,1539,1,2,chrVII,known_gene
616727,617165,438,1,2,chrVII,novel_orf
618551,618902,351,1,2,chrVII,novel_orf
635711,636152,441,1,2,chrVII,known_gene
643373,643679,306,1,2,chrVII,novel_orf
662357,666071,3714,1,2,chrVII,known_gene
672185,675500,3315,1,2,chrVII,known_gene
693362,694403,1041,1,2,chrVII,known_gene
707609,708482,873,1,2,chrVII,novel_orf
713708,715046,1338,1,2,chrVII,known_gene
718892,719924,1032,1,2,chrVII,known_gene
733934,735143,1209,1,2,chrVII,known_gene
739943,741662,1719,1,2,chrVII,known_gene
757769,761138,3369,1,2,chrVII,known_gene
762887,763262,375,1,2,chrVII,known_gene
765725,766064,339,1,2,chrVII,known_gene
780398,781379,981,1,2,chrVII,known_gene
781766,783890,2124,1,2,chrVII,known_gene
796091,796745,654,1,2,chrVII,known_gene
798542,800066,1524,1,2,chrVII,known_gene
802439,805049,2610,1,2,chrVII,known_gene
829115,830153,1038,1,2,chrVII,known_gene
847973,848315,342,1,2,chrVII,novel_orf
867773,869981,2208,1,2,chrVII,known_gene
888881,889622,741,1,2,chrVII,known_gene
894692,897146,2454,1,2,chrVII,known_gene
897986,898325,339,1,2,chrVII,known_gene
905933,908774,2841,1,2,chrVII,known_gene
909212,910085,873,1,2,chrVII,known_gene
911882,912812,930,1,2,chrVII,known_gene
917039,918446,1407,1,2,chrVII,known_gene
924695,930815,6120,1,2,chrVII,known_gene
932540,935795,3255,1,2,chrVII,known_gene
949364,949709,345,1,2,chrVII,known_gene
951893,952307,414,1,2,chrVII,known_gene
959903,961103,1200,1,2,chrVII,known_gene
968087,968417,330,1,2,chrVII,novel_orf
984965,985685,720,1,2,chrVII,known_gene
1012484,1014089,1605,1,2,chrVII,known_gene
1026635,1026962,327,1,2,chrVII,known_gene
1039955,1040273,318,1,2,chrVII,novel_orf
1062080,1062401,321,1,2,chrVII,novel_orf
1075481,1075925,444,1,2,chrVII,known_gene
1080305,1080668,363,1,2,chrVII,known_gene
1088930,1089506,576,1,2,chrVII,known_gene
1081583,1082729,1146,-1,0,chrVII,known_gene
1059014,1060040,1026,-1,0,chrVII,known_gene
1057931,1058303,372,-1,0,chrVII,known_gene
1045643,1046561,918,-1,0,chrVII,known_gene
1026056,1026653,597,-1,0,chrVII,known_gene
1025003,1025735,732,-1,0,chrVII,known_gene
1019597,1021853,2256,-1,0,chrVII,known_gene
1014320,1016750,2430,-1,0,chrVII,known_gene
998357,999140,783,-1,0,chrVII,known_gene
991175,993521,2346,-1,0,chrVII,known_gene
982481,984272,1791,-1,0,chrVII,known_gene
978035,979319,1284,-1,0,chrVII,known_gene
966038,968687,2649,-1,0,chrVII,known_gene
952547,953480,933,-1,0,chrVII,known_gene
946400,946856,456,-1,0,chrVII,known_gene
940868,942215,1347,-1,0,chrVII,known_gene
913502,914738,1236,-1,0,chrVII,known_gene
903473,904748,1275,-1,0,chrVII,known_gene
902519,903344,825,-1,0,chrVII,known_gene
899903,902270,2367,-1,0,chrVII,known_gene
892496,894140,1644,-1,0,chrVII,known_gene
880295,880661,366,-1,0,chrVII,known_gene
876668,878192,1524,-1,0,chrVII,known_gene
855263,856301,1038,-1,0,chrVII,known_gene
848828,850436,1608,-1,0,chrVII,known_gene
846932,848423,1491,-1,0,chrVII,known_gene
833351,834482,1131,-1,0,chrVII,known_gene
824525,825137,612,-1,0,chrVII,novel_orf
819632,819944,312,-1,0,chrVII,novel_orf
808628,809420,792,-1,0,chrVII,known_gene
806411,807656,1245,-1,0,chrVII,known_gene
805268,806021,753,-1,0,chrVII,known_gene
794654,794990,336,-1,0,chrVII,known_gene
786053,786920,867,-1,0,chrVII,known_gene
776609,776915,306,-1,0,chrVII,novel_orf
755588,756452,864,-1,0,chrVII,known_gene
736661,738203,1542,-1,0,chrVII,known_gene
728045,729671,1626,-1,0,chrVII,known_gene
725048,726479,1431,-1,0,chrVII,known_gene
720371,721151,780,-1,0,chrVII,known_gene
718103,718436,333,-1,0,chrVII,novel_orf
696179,696503,324,-1,0,chrVII,novel_orf
694583,695135,552,-1,0,chrVII,known_gene
682565,687458,4893,-1,0,chrVII,known_gene
637103,637577,474,-1,0,chrVII,known_gene
636146,636875,729,-1,0,chrVII,known_gene
611888,615965,4077,-1,0,chrVII,known_gene
604772,605510,738,-1,0,chrVII,known_gene
592085,592442,357,-1,0,chrVII,known_gene
586391,589469,3078,-1,0,chrVII,known_gene
582989,583892,903,-1,0,chrVII,known_gene
573092,574142,1050,-1,0,chrVII,novel_orf
566144,567467,1323,-1,0,chrVII,novel_orf
534131,534458,327,-1,0,chrVII,known_gene
529256,529586,330,-1,0,chrVII,known_gene
527714,528053,339,-1,0,chrVII,novel_orf
517331,518015,684,-1,0,chrVII,novel_orf
504656,505859,1203,-1,0,chrVII,known_gene
497420,497807,387,-1,0,chrVII,known_gene
495452,496502,1050,-1,0,chrVII,known_gene
492473,494174,1701,-1,0,chrVII,known_gene
489707,490547,840,-1,0,chrVII,known_gene
479909,482666,2757,-1,0,chrVII,known_gene
476312,478652,2340,-1,0,chrVII,known_gene
474488,475247,759,-1,0,chrVII,known_gene
469091,472298,3207,-1,0,chrVII,known_gene
448763,450059,1296,-1,0,chrVII,known_gene
446411,448535,2124,-1,0,chrVII,known_gene
406859,409604,2745,-1,0,chrVII,known_gene
388967,389711,744,-1,0,chrVII,known_gene
360287,361859,1572,-1,0,chrVII,known_gene
350615,352298,1683,-1,0,chrVII,known_gene
311504,311933,429,-1,0,chrVII,known_gene
281633,283937,2304,-1,0,chrVII,known_gene
278945,280523,1578,-1,0,chrVII,known_gene
277745,278072,327,-1,0,chrVII,known_gene
272849,273239,390,-1,0,chrVII,novel_orf
271772,272087,315,-1,0,chrVII,novel_orf
267722,269075,1353,-1,0,chrVII,known_gene
261647,265859,4212,-1,0,chrVII,known_gene
260738,261098,360,-1,0,chrVII,novel_orf
252896,253859,963,-1,0,chrVII,known_gene
241352,245012,3660,-1,0,chrVII,known_gene
234716,235958,1242,-1,0,chrVII,known_gene
227753,228329,576,-1,0,chrVII,known_gene
224639,224975,336,-1,0,chrVII,known_gene
193706,196403,2697,-1,0,chrVII,known_gene
180914,181382,468,-1,0,chrVII,novel_orf
175526,180113,4587,-1,0,chrVII,known_gene
156542,157067,525,-1,0,chrVII,known_gene
145808,147389,1581,-1,0,chrVII,known_gene
122693,123305,612,-1,0,chrVII,known_gene
102542,107504,4962,-1,0,chrVII,known_gene
93263,93719,456,-1,0,chrVII,novel_orf
90053,91247,1194,-1,0,chrVII,known_gene
82877,84257,1380,-1,0,chrVII,known_gene
81425,82292,867,-1,0,chrVII,known_gene
78014,78857,843,-1,0,chrVII,known_gene
64502,66959,2457,-1,0,chrVII,known_gene
63047,63620,573,-1,0,chrVII,known_gene
60998,61394,396,-1,0,chrVII,novel_orf
53786,55796,2010,-1,0,chrVII,known_gene
52730,53528,798,-1,0,chrVII,known_gene
50360,50786,426,-1,0,chrVII,novel_orf
49430,49745,315,-1,0,chrVII,known_gene
47531,48029,498,-1,0,chrVII,novel_orf
44651,45197,546,-1,0,chrVII,known_gene
37616,38780,1164,-1,0,chrVII,known_gene
27920,31061,3141,-1,0,chrVII,known_gene
1089745,1090228,483,-1,1,chrVII,known_gene
1088869,1089445,576,-1,1,chrVII,known_gene
1086361,1086712,351,-1,1,chrVII,novel_orf
1079884,1080346,462,-1,1,chrVII,known_gene
1073962,1075813,1851,-1,1,chrVII,known_gene
1067221,1068991,1770,-1,1,chrVII,known_gene
1061851,1063153,1302,-1,1,chrVII,known_gene
1060657,1061590,933,-1,1,chrVII,known_gene
1043818,1045480,1662,-1,1,chrVII,known_gene
1039894,1043095,3201,-1,1,chrVII,known_gene
1012480,1012921,441,-1,1,chrVII,known_gene
1006204,1007305,1101,-1,1,chrVII,known_gene
954673,958210,3537,-1,1,chrVII,known_gene
949381,950899,1518,-1,1,chrVII,known_gene
937123,938992,1869,-1,1,chrVII,known_gene
936073,936883,810,-1,1,chrVII,known_gene
918511,919465,954,-1,1,chrVII,known_gene
907957,908377,420,-1,1,chrVII,novel_orf
889732,892186,2454,-1,1,chrVII,known_gene
886072,887875,1803,-1,1,chrVII,known_gene
882811,883810,999,-1,1,chrVII,known_gene
869176,869962,786,-1,1,chrVII,novel_orf
866335,867520,1185,-1,1,chrVII,known_gene
859900,865753,5853,-1,1,chrVII,known_gene
858550,858904,354,-1,1,chrVII,known_gene
840823,842551,1728,-1,1,chrVII,known_gene
834688,835903,1215,-1,1,chrVII,known_gene
821692,823015,1323,-1,1,chrVII,novel_orf
806680,807055,375,-1,1,chrVII,known_gene
784222,784858,636,-1,1,chrVII,known_gene
751393,753844,2451,-1,1,chrVII,known_gene
747949,750091,2142,-1,1,chrVII,known_gene
740566,740869,303,-1,1,chrVII,novel_orf
728791,729157,366,-1,1,chrVII,known_gene
705358,706501,1143,-1,1,chrVII,known_gene
697444,698368,924,-1,1,chrVII,known_gene
675670,676441,771,-1,1,chrVII,known_gene
651289,652981,1692,-1,1,chrVII,known_gene
649597,650617,1020,-1,1,chrVII,known_gene
648382,648907,525,-1,1,chrVII,known_gene
647122,648142,1020,-1,1,chrVII,known_gene
643147,643780,633,-1,1,chrVII,known_gene
635614,635986,372,-1,1,chrVII,known_gene
631480,634063,2583,-1,1,chrVII,known_gene
620920,621799,879,-1,1,chrVII,known_gene
618076,619858,1782,-1,1,chrVII,known_gene
617515,617824,309,-1,1,chrVII,known_gene
616327,617278,951,-1,1,chrVII,known_gene
594985,595837,852,-1,1,chrVII,known_gene
583933,584296,363,-1,1,chrVII,known_gene
571969,573136,1167,-1,1,chrVII,novel_orf
562198,565666,3468,-1,1,chrVII,novel_orf
558148,558868,720,-1,1,chrVII,known_gene
557071,557422,351,-1,1,chrVII,known_gene
546808,547300,492,-1,1,chrVII,known_gene
545680,546157,477,-1,1,chrVII,known_gene
526972,527329,357,-1,1,chrVII,known_gene
521089,522076,987,-1,1,chrVII,known_gene
498475,499906,1431,-1,1,chrVII,known_gene
490702,491956,1254,-1,1,chrVII,known_gene
459109,459664,555,-1,1,chrVII,known_gene
457162,457870,708,-1,1,chrVII,known_gene
455479,455953,474,-1,1,chrVII,novel_orf
450196,452104,1908,-1,1,chrVII,known_gene
443641,446143,2502,-1,1,chrVII,known_gene
441280,442909,1629,-1,1,chrVII,known_gene
433213,433579,366,-1,1,chrVII,known_gene
428722,429064,342,-1,1,chrVII,novel_orf
410068,411286,1218,-1,1,chrVII,known_gene
400870,401287,417,-1,1,chrVII,known_gene
396034,397618,1584,-1,1,chrVII,known_gene
385606,385924,318,-1,1,chrVII,novel_orf
379759,381271,1512,-1,1,chrVII,known_gene
377977,378283,306,-1,1,chrVII,novel_orf
375049,375514,465,-1,1,chrVII,known_gene
374458,374827,369,-1,1,chrVII,known_gene
372733,373309,576,-1,1,chrVII,novel_orf
371002,371362,360,-1,1,chrVII,known_gene
362224,363916,1692,-1,1,chrVII,known_gene
346405,346708,303,-1,1,chrVII,known_gene
342055,343042,987,-1,1,chrVII,known_gene
331117,334465,3348,-1,1,chrVII,known_gene
328873,330607,1734,-1,1,chrVII,known_gene
319798,320122,324,-1,1,chrVII,novel_orf
298177,299728,1551,-1,1,chrVII,known_gene
290017,290425,408,-1,1,chrVII,novel_orf
288013,288451,438,-1,1,chrVII,known_gene
270391,270775,384,-1,1,chrVII,known_gene
219190,219508,318,-1,1,chrVII,novel_orf
216691,217369,678,-1,1,chrVII,known_gene
198670,198994,324,-1,1,chrVII,novel_orf
191977,193300,1323,-1,1,chrVII,known_gene
187615,190468,2853,-1,1,chrVII,known_gene
174841,175141,300,-1,1,chrVII,novel_orf
173284,174322,1038,-1,1,chrVII,known_gene
163408,165091,1683,-1,1,chrVII,known_gene
153166,154306,1140,-1,1,chrVII,known_gene
151036,152776,1740,-1,1,chrVII,known_gene
148228,148588,360,-1,1,chrVII,known_gene
124813,125137,324,-1,1,chrVII,novel_orf
123571,124042,471,-1,1,chrVII,known_gene
117853,120907,3054,-1,1,chrVII,known_gene
112474,114664,2190,-1,1,chrVII,known_gene
84838,85180,342,-1,1,chrVII,known_gene
79111,80365,1254,-1,1,chrVII,known_gene
25717,27484,1767,-1,1,chrVII,known_gene
6289,6652,363,-1,1,chrVII,known_gene
1088952,1089459,507,-1,2,chrVII,known_gene
1088247,1088583,336,-1,2,chrVII,novel_orf
1063812,1064940,1128,-1,2,chrVII,known_gene
1062003,1062492,489,-1,2,chrVII,known_gene
1057782,1058724,942,-1,2,chrVII,known_gene
1050909,1051725,816,-1,2,chrVII,known_gene
1048797,1049958,1161,-1,2,chrVII,known_gene
1038714,1039239,525,-1,2,chrVII,known_gene
1037799,1038501,702,-1,2,chrVII,known_gene
1017966,1019241,1275,-1,2,chrVII,known_gene
1016973,1017759,786,-1,2,chrVII,known_gene
1007670,1010766,3096,-1,2,chrVII,known_gene
1002522,1003962,1440,-1,2,chrVII,known_gene
996897,997236,339,-1,2,chrVII,novel_orf
988947,989247,300,-1,2,chrVII,novel_orf
979764,982068,2304,-1,2,chrVII,known_gene
974874,976581,1707,-1,2,chrVII,known_gene
970770,973734,2964,-1,2,chrVII,known_gene
969186,970053,867,-1,2,chrVII,known_gene
963297,965655,2358,-1,2,chrVII,known_gene
961359,962061,702,-1,2,chrVII,known_gene
942849,943281,432,-1,2,chrVII,novel_orf
922632,924462,1830,-1,2,chrVII,known_gene
912912,913227,315,-1,2,chrVII,known_gene
910842,911628,786,-1,2,chrVII,known_gene
884508,885741,1233,-1,2,chrVII,known_gene
872043,875109,3066,-1,2,chrVII,known_gene
870231,871416,1185,-1,2,chrVII,known_gene
860007,860310,303,-1,2,chrVII,known_gene
853674,854895,1221,-1,2,chrVII,known_gene
851046,853215,2169,-1,2,chrVII,known_gene
845892,846405,513,-1,2,chrVII,known_gene
842844,843591,747,-1,2,chrVII,known_gene
817746,821214,3468,-1,2,chrVII,novel_orf
814929,815244,315,-1,2,chrVII,novel_orf
796797,797868,1071,-1,2,chrVII,known_gene
794673,795492,819,-1,2,chrVII,known_gene
790458,793053,2595,-1,2,chrVII,known_gene
787311,787779,468,-1,2,chrVII,known_gene
763761,765606,1845,-1,2,chrVII,known_gene
731448,732927,1479,-1,2,chrVII,known_gene
730032,730860,828,-1,2,chrVII,known_gene
720264,720654,390,-1,2,chrVII,known_gene
698988,699786,798,-1,2,chrVII,known_gene
696144,696450,306,-1,2,chrVII,novel_orf
692175,692658,483,-1,2,chrVII,novel_orf
656979,657327,348,-1,2,chrVII,novel_orf
644859,646815,1956,-1,2,chrVII,known_gene
639771,640371,600,-1,2,chrVII,known_gene
637743,639513,1770,-1,2,chrVII,known_gene
634878,635247,369,-1,2,chrVII,novel_orf
629019,629487,468,-1,2,chrVII,novel_orf
625323,627084,1761,-1,2,chrVII,known_gene
622371,624786,2415,-1,2,chrVII,known_gene
592905,593229,324,-1,2,chrVII,known_gene
580434,581436,1002,-1,2,chrVII,known_gene
569094,571398,2304,-1,2,chrVII,novel_orf
554247,554967,720,-1,2,chrVII,known_gene
531882,532596,714,-1,2,chrVII,known_gene
524364,524694,330,-1,2,chrVII,known_gene
509046,511002,1956,-1,2,chrVII,known_gene
488280,488619,339,-1,2,chrVII,novel_orf
465042,465435,393,-1,2,chrVII,known_gene
437466,437934,468,-1,2,chrVII,known_gene
435969,436329,360,-1,2,chrVII,novel_orf
431547,433062,1515,-1,2,chrVII,known_gene
427296,427947,651,-1,2,chrVII,known_gene
425361,426804,1443,-1,2,chrVII,known_gene
419526,420555,1029,-1,2,chrVII,known_gene
418287,418593,306,-1,2,chrVII,known_gene
416145,417036,891,-1,2,chrVII,known_gene
394965,395829,864,-1,2,chrVII,known_gene
390114,390432,318,-1,2,chrVII,novel_orf
383682,384015,333,-1,2,chrVII,novel_orf
381522,383208,1686,-1,2,chrVII,known_gene
369717,370272,555,-1,2,chrVII,novel_orf
368595,368922,327,-1,2,chrVII,known_gene
366924,368088,1164,-1,2,chrVII,known_gene
344790,345153,363,-1,2,chrVII,known_gene
336390,336738,348,-1,2,chrVII,novel_orf
308712,310173,1461,-1,2,chrVII,known_gene
304332,306273,1941,-1,2,chrVII,known_gene
303648,304071,423,-1,2,chrVII,known_gene
301536,303411,1875,-1,2,chrVII,known_gene
300111,300414,303,-1,2,chrVII,novel_orf
280776,281157,381,-1,2,chrVII,known_gene
274779,276714,1935,-1,2,chrVII,known_gene
271242,271605,363,-1,2,chrVII,novel_orf
269292,270336,1044,-1,2,chrVII,known_gene
250077,250386,309,-1,2,chrVII,novel_orf
248493,249531,1038,-1,2,chrVII,known_gene
239553,239877,324,-1,2,chrVII,novel_orf
236268,238119,1851,-1,2,chrVII,known_gene
232449,234507,2058,-1,2,chrVII,known_gene
228750,229686,936,-1,2,chrVII,known_gene
221103,225573,4470,-1,2,chrVII,known_gene
215277,216096,819,-1,2,chrVII,known_gene
209115,209427,312,-1,2,chrVII,novel_orf
199209,200142,933,-1,2,chrVII,known_gene
191397,191976,579,-1,2,chrVII,known_gene
184152,185394,1242,-1,2,chrVII,known_gene
171414,173079,1665,-1,2,chrVII,known_gene
157272,157596,324,-1,2,chrVII,known_gene
154614,156012,1398,-1,2,chrVII,known_gene
149703,150171,468,-1,2,chrVII,known_gene
141915,142227,312,-1,2,chrVII,known_gene
140367,141726,1359,-1,2,chrVII,known_gene
138927,139347,420,-1,2,chrVII,novel_orf
137322,137733,411,-1,2,chrVII,novel_orf
134232,134604,372,-1,2,chrVII,novel_orf
133641,134037,396,-1,2,chrVII,novel_orf
111699,112005,306,-1,2,chrVII,known_gene
80658,81186,528,-1,2,chrVII,known_gene
63771,64215,444,-1,2,chrVII,known_gene
40248,40677,429,-1,2,chrVII,novel_orf
12480,14157,1677,-1,2,chrVII,known_gene
810,1293,483,1,0,chrVIII,known_gene
1593,2037,444,1,0,chrVIII,novel_orf
2328,2664,336,1,0,chrVIII,novel_orf
12501,12849,348,1,0,chrVIII,known_gene
15666,16119,453,1,0,chrVIII,known_gene
17391,17841,450,1,0,chrVIII,known_gene
40083,45690,5607,1,0,chrVIII,known_gene
48762,50580,1818,1,0,chrVIII,known_gene
52353,52677,324,1,0,chrVIII,known_gene
58272,58605,333,1,0,chrVIII,known_gene
67710,68304,594,1,0,chrVIII,known_gene
68775,69147,372,1,0,chrVIII,novel_orf
70275,71874,1599,1,0,chrVIII,known_gene
75411,75777,366,1,0,chrVIII,known_gene
85908,87150,1242,1,0,chrVIII,novel_orf
97731,98085,354,1,0,chrVIII,known_gene
117813,119439,1626,1,0,chrVIII,known_gene
123105,123414,309,1,0,chrVIII,novel_orf
127779,129120,1341,1,0,chrVIII,known_gene
134553,136533,1980,1,0,chrVIII,known_gene
138693,139851,1158,1,0,chrVIII,known_gene
142248,142602,354,1,0,chrVIII,novel_orf
151665,157452,5787,1,0,chrVIII,known_gene
162516,162861,345,1,0,chrVIII,novel_orf
173343,175089,1746,1,0,chrVIII,known_gene
178218,180111,1893,1,0,chrVIII,known_gene
184065,184758,693,1,0,chrVIII,known_gene
187923,189024,1101,1,0,chrVIII,known_gene
190542,192618,2076,1,0,chrVIII,known_gene
204606,206151,1545,1,0,chrVIII,known_gene
220107,220500,393,1,0,chrVIII,known_gene
225441,225777,336,1,0,chrVIII,known_gene
228282,228588,306,1,0,chrVIII,novel_orf
237003,237693,690,1,0,chrVIII,known_gene
239097,241293,2196,1,0,chrVIII,known_gene
246192,248337,2145,1,0,chrVIII,known_gene
251100,252225,1125,1,0,chrVIII,known_gene
256359,258018,1659,1,0,chrVIII,known_gene
267537,268092,555,1,0,chrVIII,known_gene
274173,276240,2067,1,0,chrVIII,known_gene
302760,313995,11235,1,0,chrVIII,known_gene
324765,325410,645,1,0,chrVIII,known_gene
328302,330060,1758,1,0,chrVIII,known_gene
330309,332067,1758,1,0,chrVIII,known_gene
336336,337809,1473,1,0,chrVIII,known_gene
338082,339984,1902,1,0,chrVIII,known_gene
341664,342120,456,1,0,chrVIII,known_gene
342348,344268,1920,1,0,chrVIII,known_gene
352755,353319,564,1,0,chrVIII,known_gene
358857,359163,306,1,0,chrVIII,known_gene
360912,361644,732,1,0,chrVIII,known_gene
370053,370449,396,1,0,chrVIII,known_gene
371748,372558,810,1,0,chrVIII,known_gene
375708,377250,1542,1,0,chrVIII,known_gene
380571,381291,720,1,0,chrVIII,known_gene
385509,386487,978,1,0,chrVIII,known_gene
401433,401955,522,1,0,chrVIII,known_gene
423723,424473,750,1,0,chrVIII,known_gene
439341,440127,786,1,0,chrVIII,known_gene
440376,441933,1557,1,0,chrVIII,known_gene
451326,452640,1314,1,0,chrVIII,known_gene
452871,453441,570,1,0,chrVIII,known_gene
462501,463704,1203,1,0,chrVIII,known_gene
465177,465669,492,1,0,chrVIII,known_gene
472743,474459,1716,1,0,chrVIII,known_gene
486825,487662,837,1,0,chrVIII,known_gene
490746,491712,966,1,0,chrVIII,known_gene
541650,542262,612,1,0,chrVIII,known_gene
560172,562047,1875,1,0,chrVIII,known_gene
1579,1954,375,1,1,chrVIII,novel_orf
6400,7546,1146,1,1,chrVIII,known_gene
13564,14272,708,1,1,chrVIII,known_gene
23926,24295,369,1,1,chrVIII,novel_orf
33175,33637,462,1,1,chrVIII,known_gene
39073,39535,462,1,1,chrVIII,known_gene
54850,55849,999,1,1,chrVIII,known_gene
70366,70666,300,1,1,chrVIII,known_gene
87391,91318,3927,1,1,chrVIII,novel_orf
106054,107368,1314,1,1,chrVIII,known_gene
108811,109885,1074,1,1,chrVIII,known_gene
127003,127492,489,1,1,chrVIII,known_gene
132046,132922,876,1,1,chrVIII,known_gene
143995,146062,2067,1,1,chrVIII,known_gene
149224,149680,456,1,1,chrVIII,known_gene
160843,161485,642,1,1,chrVIII,known_gene
195550,197233,1683,1,1,chrVIII,known_gene
206461,207193,732,1,1,chrVIII,known_gene
209704,210151,447,1,1,chrVIII,known_gene
210847,211978,1131,1,1,chrVIII,known_gene
217405,217840,435,1,1,chrVIII,known_gene
232132,233296,1164,1,1,chrVIII,known_gene
234880,236380,1500,1,1,chrVIII,known_gene
242581,245572,2991,1,1,chrVIII,known_gene
259612,260131,519,1,1,chrVIII,novel_orf
265237,265759,522,1,1,chrVIII,novel_orf
272626,273616,990,1,1,chrVIII,known_gene
275401,275905,504,1,1,chrVIII,known_gene
276763,277768,1005,1,1,chrVIII,known_gene
278152,279724,1572,1,1,chrVIII,known_gene
280819,281155,336,1,1,chrVIII,known_gene
281494,282382,888,1,1,chrVIII,known_gene
284053,284389,336,1,1,chrVIII,novel_orf
285400,285823,423,1,1,chrVIII,novel_orf
289141,289690,549,1,1,chrVIII,known_gene
292942,293437,495,1,1,chrVIII,known_gene
297619,298045,426,1,1,chrVIII,novel_orf
320413,322972,2559,1,1,chrVIII,known_gene
325597,326626,1029,1,1,chrVIII,known_gene
332281,332920,639,1,1,chrVIII,known_gene
346042,349285,3243,1,1,chrVIII,known_gene
349573,352453,2880,1,1,chrVIII,known_gene
356560,358444,1884,1,1,chrVIII,known_gene
373579,373924,345,1,1,chrVIII,novel_orf
412906,413455,549,1,1,chrVIII,known_gene
442180,443476,1296,1,1,chrVIII,known_gene
443827,445384,1557,1,1,chrVIII,known_gene
454228,455527,1299,1,1,chrVIII,known_gene
459298,461530,2232,1,1,chrVIII,known_gene
467227,467914,687,1,1,chrVIII,known_gene
470959,472429,1470,1,1,chrVIII,known_gene
479359,479710,351,1,1,chrVIII,novel_orf
484027,484600,573,1,1,chrVIII,known_gene
488656,490396,1740,1,1,chrVIII,known_gene
496504,496819,315,1,1,chrVIII,novel_orf
499078,499885,807,1,1,chrVIII,known_gene
502387,504196,1809,1,1,chrVIII,known_gene
509362,511837,2475,1,1,chrVIII,known_gene
512731,514600,1869,1,1,chrVIII,known_gene
517531,518713,1182,1,1,chrVIII,known_gene
519421,520312,891,1,1,chrVIII,known_gene
525391,528619,3228,1,1,chrVIII,known_gene
540799,541099,300,1,1,chrVIII,known_gene
543007,543493,486,1,1,chrVIII,known_gene
554395,555967,1572,1,1,chrVIII,known_gene
558013,558637,624,1,1,chrVIII,known_gene
559051,559924,873,1,1,chrVIII,known_gene
560383,560959,576,1,1,chrVIII,known_gene
9980,10307,327,1,2,chrVIII,known_gene
14900,15413,513,1,2,chrVIII,known_gene
21782,23540,1758,1,2,chrVIII,known_gene
26240,27881,1641,1,2,chrVIII,known_gene
35372,35798,426,1,2,chrVIII,novel_orf
37049,37388,339,1,2,chrVIII,novel_orf
47606,47933,327,1,2,chrVIII,novel_orf
51110,52988,1878,1,2,chrVIII,known_gene
56648,58790,2142,1,2,chrVIII,known_gene
69707,70070,363,1,2,chrVIII,known_gene
78935,80417,1482,1,2,chrVIII,known_gene
80735,81128,393,1,2,chrVIII,novel_orf
99218,100403,1185,1,2,chrVIII,known_gene
102611,103970,1359,1,2,chrVIII,known_gene
129851,130448,597,1,2,chrVIII,known_gene
137156,137459,303,1,2,chrVIII,novel_orf
159437,160511,1074,1,2,chrVIII,known_gene
167351,167672,321,1,2,chrVIII,known_gene
175547,176819,1272,1,2,chrVIII,known_gene
180344,181760,1416,1,2,chrVIII,known_gene
181976,183704,1728,1,2,chrVIII,known_gene
189254,189761,507,1,2,chrVIII,novel_orf
199274,199613,339,1,2,chrVIII,novel_orf
207653,209303,1650,1,2,chrVIII,known_gene
220724,221270,546,1,2,chrVIII,known_gene
229334,230696,1362,1,2,chrVIII,known_gene
230969,231812,843,1,2,chrVIII,known_gene
259538,259874,336,1,2,chrVIII,novel_orf
266213,266555,342,1,2,chrVIII,novel_orf
286190,286643,453,1,2,chrVIII,novel_orf
316571,319814,3243,1,2,chrVIII,known_gene
323408,324392,984,1,2,chrVIII,known_gene
333071,334394,1323,1,2,chrVIII,known_gene
344453,345206,753,1,2,chrVIII,novel_orf
353624,354320,696,1,2,chrVIII,known_gene
355040,356081,1041,1,2,chrVIII,known_gene
362009,362765,756,1,2,chrVIII,known_gene
383537,384488,951,1,2,chrVIII,known_gene
390299,391697,1398,1,2,chrVIII,known_gene
393533,394085,552,1,2,chrVIII,known_gene
397250,398990,1740,1,2,chrVIII,known_gene
402965,406178,3213,1,2,chrVIII,known_gene
407102,410789,3687,1,2,chrVIII,known_gene
417548,419063,1515,1,2,chrVIII,known_gene
423071,423461,390,1,2,chrVIII,known_gene
426053,426461,408,1,2,chrVIII,novel_orf
432899,433259,360,1,2,chrVIII,novel_orf
436646,436958,312,1,2,chrVIII,known_gene
445712,447605,1893,1,2,chrVIII,known_gene
448334,450806,2472,1,2,chrVIII,known_gene
456590,457952,1362,1,2,chrVIII,known_gene
468218,470576,2358,1,2,chrVIII,known_gene
480989,481919,930,1,2,chrVIII,known_gene
484844,486179,1335,1,2,chrVIII,known_gene
491930,493658,1728,1,2,chrVIII,known_gene
493895,496187,2292,1,2,chrVIII,known_gene
506318,508709,2391,1,2,chrVIII,known_gene
539150,539747,597,1,2,chrVIII,known_gene
548666,549002,336,1,2,chrVIII,novel_orf
552098,553502,1404,1,2,chrVIII,known_gene
559931,560249,318,1,2,chrVIII,known_gene
560405,560912,507,-1,0,chrVIII,novel_orf
556580,557042,462,-1,0,chrVIII,known_gene
545768,546161,393,-1,0,chrVIII,novel_orf
537758,538094,336,-1,0,chrVIII,known_gene
514904,516485,1581,-1,0,chrVIII,known_gene
507767,508073,306,-1,0,chrVIII,novel_orf
499949,501143,1194,-1,0,chrVIII,known_gene
497489,498422,933,-1,0,chrVIII,known_gene
474626,475340,714,-1,0,chrVIII,known_gene
473204,473552,348,-1,0,chrVIII,novel_orf
451358,451877,519,-1,0,chrVIII,novel_orf
441239,441740,501,-1,0,chrVIII,novel_orf
413684,417179,3495,-1,0,chrVIII,known_gene
411383,412406,1023,-1,0,chrVIII,known_gene
394454,396659,2205,-1,0,chrVIII,known_gene
378218,379199,981,-1,0,chrVIII,known_gene
377354,377699,345,-1,0,chrVIII,known_gene
375737,376388,651,-1,0,chrVIII,known_gene
370721,371597,876,-1,0,chrVIII,known_gene
368501,369794,1293,-1,0,chrVIII,known_gene
365339,367892,2553,-1,0,chrVIII,known_gene
364964,365300,336,-1,0,chrVIII,known_gene
360947,361451,504,-1,0,chrVIII,novel_orf
339257,339836,579,-1,0,chrVIII,novel_orf
334526,335663,1137,-1,0,chrVIII,known_gene
299144,301934,2790,-1,0,chrVIII,known_gene
294668,296447,1779,-1,0,chrVIII,known_gene
290912,292625,1713,-1,0,chrVIII,known_gene
282680,283298,618,-1,0,chrVIII,known_gene
248438,249641,1203,-1,0,chrVIII,known_gene
227531,229163,1632,-1,0,chrVIII,known_gene
225524,227243,1719,-1,0,chrVIII,known_gene
218996,219884,888,-1,0,chrVIII,known_gene
218225,218843,618,-1,0,chrVIII,known_gene
204956,205256,300,-1,0,chrVIII,novel_orf
184874,186809,1935,-1,0,chrVIII,known_gene
170798,172970,2172,-1,0,chrVIII,known_gene
161729,164711,2982,-1,0,chrVIII,known_gene
141893,143558,1665,-1,0,chrVIII,known_gene
136880,138029,1149,-1,0,chrVIII,known_gene
136262,136562,300,-1,0,chrVIII,novel_orf
122888,123590,702,-1,0,chrVIII,known_gene
113498,114917,1419,-1,0,chrVIII,known_gene
110027,111317,1290,-1,0,chrVIII,known_gene
98342,98795,453,-1,0,chrVIII,known_gene
95117,97937,2820,-1,0,chrVIII,known_gene
77429,78353,924,-1,0,chrVIII,known_gene
67730,69548,1818,-1,0,chrVIII,known_gene
62960,64157,1197,-1,0,chrVIII,known_gene
49079,49514,435,-1,0,chrVIII,novel_orf
45053,45458,405,-1,0,chrVIII,novel_orf
43718,44021,303,-1,0,chrVIII,novel_orf
27977,32756,4779,-1,0,chrVIII,known_gene
3725,4541,816,-1,0,chrVIII,known_gene
2207,3311,1104,-1,0,chrVIII,known_gene
1532,1976,444,-1,0,chrVIII,known_gene
547909,549346,1437,-1,1,chrVIII,novel_orf
520711,521737,1026,-1,1,chrVIII,known_gene
512821,513127,306,-1,1,chrVIII,novel_orf
504475,505066,591,-1,1,chrVIII,known_gene
487711,488236,525,-1,1,chrVIII,known_gene
486229,486631,402,-1,1,chrVIII,known_gene
473275,473647,372,-1,1,chrVIII,novel_orf
470938,471412,474,-1,1,chrVIII,known_gene
470227,470548,321,-1,1,chrVIII,novel_orf
469516,469822,306,-1,1,chrVIII,novel_orf
450814,451153,339,-1,1,chrVIII,known_gene
446284,446677,393,-1,1,chrVIII,novel_orf
444127,444529,402,-1,1,chrVIII,novel_orf
429706,436948,7242,-1,1,chrVIII,known_gene
424609,429178,4569,-1,1,chrVIII,known_gene
418513,418876,363,-1,1,chrVIII,novel_orf
416704,417136,432,-1,1,chrVIII,known_gene
404515,404881,366,-1,1,chrVIII,novel_orf
402085,402682,597,-1,1,chrVIII,known_gene
392638,393283,645,-1,1,chrVIII,known_gene
387787,388726,939,-1,1,chrVIII,known_gene
380107,380419,312,-1,1,chrVIII,known_gene
374653,375100,447,-1,1,chrVIII,known_gene
362998,364153,1155,-1,1,chrVIII,known_gene
359701,360181,480,-1,1,chrVIII,known_gene
344320,345628,1308,-1,1,chrVIII,known_gene
340108,341359,1251,-1,1,chrVIII,known_gene
326812,328036,1224,-1,1,chrVIII,known_gene
318229,318544,315,-1,1,chrVIII,novel_orf
287080,288811,1731,-1,1,chrVIII,known_gene
252373,255649,3276,-1,1,chrVIII,known_gene
238909,239230,321,-1,1,chrVIII,known_gene
236101,236512,411,-1,1,chrVIII,known_gene
233578,234658,1080,-1,1,chrVIII,known_gene
224029,225169,1140,-1,1,chrVIII,known_gene
221533,222478,945,-1,1,chrVIII,known_gene
215182,217834,2652,-1,1,chrVIII,known_gene
213184,214249,1065,-1,1,chrVIII,known_gene
198739,201310,2571,-1,1,chrVIII,known_gene
189130,189595,465,-1,1,chrVIII,known_gene
175558,176212,654,-1,1,chrVIII,novel_orf
168889,170344,1455,-1,1,chrVIII,known_gene
164977,167434,2457,-1,1,chrVIII,known_gene
137314,137620,306,-1,1,chrVIII,known_gene
130729,131446,717,-1,1,chrVIII,known_gene
124108,125680,1572,-1,1,chrVIII,known_gene
102586,103075,489,-1,1,chrVIII,known_gene
98827,99220,393,-1,1,chrVIII,known_gene
92626,94510,1884,-1,1,chrVIII,known_gene
84067,85060,993,-1,1,chrVIII,known_gene
80653,81616,963,-1,1,chrVIII,known_gene
76096,77314,1218,-1,1,chrVIII,known_gene
66241,67456,1215,-1,1,chrVIII,known_gene
59122,62563,3441,-1,1,chrVIII,known_gene
54820,55915,1095,-1,1,chrVIII,novel_orf
53218,54166,948,-1,1,chrVIII,known_gene
45928,47968,2040,-1,1,chrVIII,known_gene
35254,36025,771,-1,1,chrVIII,known_gene
25777,26179,402,-1,1,chrVIII,known_gene
22264,22573,309,-1,1,chrVIII,novel_orf
19087,20971,1884,-1,1,chrVIII,known_gene
8350,10213,1863,-1,1,chrVIII,known_gene
561198,561681,483,-1,2,chrVIII,known_gene
560322,560898,576,-1,2,chrVIII,novel_orf
551199,551499,300,-1,2,chrVIII,known_gene
543963,547431,3468,-1,2,chrVIII,novel_orf
527766,528168,402,-1,2,chrVIII,novel_orf
511431,511800,369,-1,2,chrVIII,novel_orf
496314,497280,966,-1,2,chrVIII,known_gene
488652,489027,375,-1,2,chrVIII,known_gene
482004,483837,1833,-1,2,chrVIII,known_gene
475998,480672,4674,-1,2,chrVIII,known_gene
459897,460203,306,-1,2,chrVIII,novel_orf
449580,449886,306,-1,2,chrVIII,novel_orf
437169,439050,1881,-1,2,chrVIII,known_gene
420372,422286,1914,-1,2,chrVIII,known_gene
419220,420072,852,-1,2,chrVIII,known_gene
399267,400848,1581,-1,2,chrVIII,known_gene
388980,389337,357,-1,2,chrVIII,known_gene
372693,374310,1617,-1,2,chrVIII,known_gene
351684,352164,480,-1,2,chrVIII,novel_orf
314115,314673,558,-1,2,chrVIII,known_gene
297384,298080,696,-1,2,chrVIII,known_gene
293796,294096,300,-1,2,chrVIII,novel_orf
284838,286770,1932,-1,2,chrVIII,known_gene
283776,284625,849,-1,2,chrVIII,known_gene
268458,271548,3090,-1,2,chrVIII,known_gene
262800,266838,4038,-1,2,chrVIII,known_gene
258243,261591,3348,-1,2,chrVIII,known_gene
235335,235785,450,-1,2,chrVIII,novel_orf
234873,235236,363,-1,2,chrVIII,known_gene
232665,233007,342,-1,2,chrVIII,novel_orf
222876,223758,882,-1,2,chrVIII,known_gene
197397,198285,888,-1,2,chrVIII,known_gene
194067,194808,741,-1,2,chrVIII,known_gene
192804,193545,741,-1,2,chrVIII,known_gene
191076,191460,384,-1,2,chrVIII,novel_orf
176964,177999,1035,-1,2,chrVIII,known_gene
167676,168561,885,-1,2,chrVIII,known_gene
157743,159192,1449,-1,2,chrVIII,known_gene
149574,150345,771,-1,2,chrVIII,known_gene
147870,148209,339,-1,2,chrVIII,known_gene
140010,141402,1392,-1,2,chrVIII,known_gene
120090,121683,1593,-1,2,chrVIII,known_gene
111753,113094,1341,-1,2,chrVIII,known_gene
100647,101883,1236,-1,2,chrVIII,known_gene
81963,83721,1758,-1,2,chrVIII,known_gene
72036,74244,2208,-1,2,chrVIII,known_gene
64461,65859,1398,-1,2,chrVIII,known_gene
38814,39486,672,-1,2,chrVIII,known_gene
36378,38508,2130,-1,2,chrVIII,known_gene
33192,34077,885,-1,2,chrVIII,known_gene
23616,25509,1893,-1,2,chrVIII,known_gene
11922,12285,363,-1,2,chrVIII,known_gene
444,2088,1644,-1,2,chrVIII,known_gene
1614,2397,783,1,0,chrIX,novel_orf
2766,3102,336,1,0,chrIX,novel_orf
29031,29415,384,1,0,chrIX,novel_orf
29415,30048,633,1,0,chrIX,novel_orf
39432,40140,708,1,0,chrIX,known_gene
46200,46815,615,1,0,chrIX,known_gene
48090,51306,3216,1,0,chrIX,known_gene
55197,56379,1182,1,0,chrIX,known_gene
56544,57252,708,1,0,chrIX,known_gene
83301,84885,1584,1,0,chrIX,known_gene
85365,87837,2472,1,0,chrIX,known_gene
93618,94800,1182,1,0,chrIX,known_gene
107166,107490,324,1,0,chrIX,novel_orf
113805,116904,3099,1,0,chrIX,known_gene
122688,125733,3045,1,0,chrIX,known_gene
132243,133872,1629,1,0,chrIX,known_gene
144267,144639,372,1,0,chrIX,known_gene
146202,146514,312,1,0,chrIX,novel_orf
146835,147336,501,1,0,chrIX,novel_orf
150558,151188,630,1,0,chrIX,known_gene
171750,173028,1278,1,0,chrIX,known_gene
177372,177726,354,1,0,chrIX,known_gene
180426,181977,1551,1,0,chrIX,known_gene
183936,186369,2433,1,0,chrIX,known_gene
206580,210132,3552,1,0,chrIX,novel_orf
216468,217548,1080,1,0,chrIX,known_gene
228549,229026,477,1,0,chrIX,known_gene
249990,251913,1923,1,0,chrIX,known_gene
255051,255867,816,1,0,chrIX,known_gene
258912,259770,858,1,0,chrIX,known_gene
260157,260919,762,1,0,chrIX,known_gene
268650,270573,1923,1,0,chrIX,known_gene
277722,278139,417,1,0,chrIX,known_gene
292632,295737,3105,1,0,chrIX,known_gene
321453,321933,480,1,0,chrIX,known_gene
322341,324105,1764,1,0,chrIX,known_gene
333726,334536,810,1,0,chrIX,known_gene
334881,335529,648,1,0,chrIX,known_gene
344061,345183,1122,1,0,chrIX,known_gene
358713,359028,315,1,0,chrIX,novel_orf
383565,384165,600,1,0,chrIX,known_gene
397293,398385,1092,1,0,chrIX,known_gene
407076,407379,303,1,0,chrIX,novel_orf
422634,423036,402,1,0,chrIX,known_gene
11491,16141,4650,1,1,chrIX,known_gene
18259,18712,453,1,1,chrIX,known_gene
19846,21220,1374,1,1,chrIX,novel_orf
37000,38983,1983,1,1,chrIX,known_gene
41824,45952,4128,1,1,chrIX,known_gene
63655,63997,342,1,1,chrIX,novel_orf
78073,80149,2076,1,1,chrIX,known_gene
95215,95551,336,1,1,chrIX,novel_orf
102781,105676,2895,1,1,chrIX,known_gene
117991,122071,4080,1,1,chrIX,known_gene
130609,131665,1056,1,1,chrIX,known_gene
134416,136108,1692,1,1,chrIX,known_gene
142927,144085,1158,1,1,chrIX,known_gene
146863,147175,312,1,1,chrIX,novel_orf
151594,154846,3252,1,1,chrIX,known_gene
178003,179653,1650,1,1,chrIX,known_gene
193594,195070,1476,1,1,chrIX,known_gene
195598,196216,618,1,1,chrIX,known_gene
241942,242716,774,1,1,chrIX,known_gene
242785,243097,312,1,1,chrIX,novel_orf
243100,243628,528,1,1,chrIX,novel_orf
246391,246826,435,1,1,chrIX,known_gene
254542,254860,318,1,1,chrIX,known_gene
261436,264892,3456,1,1,chrIX,known_gene
266641,267055,414,1,1,chrIX,novel_orf
278425,279847,1422,1,1,chrIX,known_gene
295564,295903,339,1,1,chrIX,known_gene
299734,300106,372,1,1,chrIX,known_gene
304708,305029,321,1,1,chrIX,novel_orf
311164,312460,1296,1,1,chrIX,known_gene
312904,313861,957,1,1,chrIX,known_gene
333010,333352,342,1,1,chrIX,known_gene
339343,341428,2085,1,1,chrIX,known_gene
342535,342835,300,1,1,chrIX,known_gene
345691,347797,2106,1,1,chrIX,known_gene
357958,358261,303,1,1,chrIX,novel_orf
363220,364519,1299,1,1,chrIX,known_gene
364888,365335,447,1,1,chrIX,known_gene
367660,368026,366,1,1,chrIX,novel_orf
374524,374860,336,1,1,chrIX,known_gene
375430,377161,1731,1,1,chrIX,known_gene
380983,381814,831,1,1,chrIX,known_gene
382627,383425,798,1,1,chrIX,known_gene
390481,390952,471,1,1,chrIX,novel_orf
391051,392809,1758,1,1,chrIX,novel_orf
410806,411838,1032,1,1,chrIX,known_gene
422353,422704,351,1,1,chrIX,known_gene
423127,423619,492,1,1,chrIX,known_gene
845,1328,483,1,2,chrIX,known_gene
1628,2480,852,1,2,chrIX,novel_orf
4637,5075,438,1,2,chrIX,novel_orf
19514,19844,330,1,2,chrIX,novel_orf
47291,47693,402,1,2,chrIX,known_gene
53990,54302,312,1,2,chrIX,novel_orf
70229,70673,444,1,2,chrIX,novel_orf
72137,72548,411,1,2,chrIX,novel_orf
85052,85442,390,1,2,chrIX,known_gene
97394,98330,936,1,2,chrIX,known_gene
105008,105527,519,1,2,chrIX,known_gene
126203,127097,894,1,2,chrIX,known_gene
128150,129581,1431,1,2,chrIX,known_gene
139751,140447,696,1,2,chrIX,known_gene
155420,155765,345,1,2,chrIX,known_gene
156044,157178,1134,1,2,chrIX,known_gene
160886,162977,2091,1,2,chrIX,known_gene
166733,167444,711,1,2,chrIX,known_gene
189065,190967,1902,1,2,chrIX,known_gene
205634,206507,873,1,2,chrIX,known_gene
212498,214703,2205,1,2,chrIX,known_gene
226601,228419,1818,1,2,chrIX,known_gene
233012,233396,384,1,2,chrIX,known_gene
237365,237809,444,1,2,chrIX,known_gene
266042,266396,354,1,2,chrIX,novel_orf
271160,272777,1617,1,2,chrIX,known_gene
276524,277505,981,1,2,chrIX,known_gene
280799,281141,342,1,2,chrIX,novel_orf
285665,287429,1764,1,2,chrIX,known_gene
302099,302498,399,1,2,chrIX,known_gene
309398,309740,342,1,2,chrIX,novel_orf
315092,316133,1041,1,2,chrIX,known_gene
326102,327995,1893,1,2,chrIX,known_gene
349121,350003,882,1,2,chrIX,known_gene
353939,355481,1542,1,2,chrIX,known_gene
360884,362924,2040,1,2,chrIX,known_gene
370703,372998,2295,1,2,chrIX,known_gene
378485,379781,1296,1,2,chrIX,known_gene
381947,382382,435,1,2,chrIX,known_gene
384608,385346,738,1,2,chrIX,known_gene
398732,399236,504,1,2,chrIX,known_gene
399776,402689,2913,1,2,chrIX,known_gene
403658,404765,1107,1,2,chrIX,known_gene
408467,410375,1908,1,2,chrIX,known_gene
412898,413282,384,1,2,chrIX,known_gene
414266,414623,357,1,2,chrIX,novel_orf
416123,419465,3342,1,2,chrIX,known_gene
433928,434303,375,1,2,chrIX,known_gene
423808,424513,705,-1,0,chrIX,known_gene
422410,422782,372,-1,0,chrIX,known_gene
419614,420736,1122,-1,0,chrIX,known_gene
413014,414679,1665,-1,0,chrIX,known_gene
404872,405967,1095,-1,0,chrIX,known_gene
402382,402706,324,-1,0,chrIX,known_gene
401914,402283,369,-1,0,chrIX,novel_orf
379027,379468,441,-1,0,chrIX,novel_orf
375556,375895,339,-1,0,chrIX,novel_orf
362092,362587,495,-1,0,chrIX,novel_orf
350590,353431,2841,-1,0,chrIX,known_gene
339889,340291,402,-1,0,chrIX,novel_orf
318199,320965,2766,-1,0,chrIX,known_gene
309385,310426,1041,-1,0,chrIX,known_gene
308200,308575,375,-1,0,chrIX,known_gene
289225,290089,864,-1,0,chrIX,known_gene
280141,282652,2511,-1,0,chrIX,known_gene
275107,276292,1185,-1,0,chrIX,known_gene
265114,267823,2709,-1,0,chrIX,known_gene
257842,258280,438,-1,0,chrIX,known_gene
243997,244462,465,-1,0,chrIX,known_gene
235723,237760,2037,-1,0,chrIX,known_gene
233056,235474,2418,-1,0,chrIX,known_gene
221080,222490,1410,-1,0,chrIX,known_gene
214990,215953,963,-1,0,chrIX,known_gene
210922,212005,1083,-1,0,chrIX,known_gene
200152,200461,309,-1,0,chrIX,known_gene
199645,200119,474,-1,0,chrIX,known_gene
191029,193195,2166,-1,0,chrIX,known_gene
182116,183127,1011,-1,0,chrIX,known_gene
175306,177250,1944,-1,0,chrIX,known_gene
169981,171505,1524,-1,0,chrIX,known_gene
161140,161473,333,-1,0,chrIX,novel_orf
157384,160165,2781,-1,0,chrIX,known_gene
146725,147145,420,-1,0,chrIX,known_gene
100780,102235,1455,-1,0,chrIX,known_gene
99859,100501,642,-1,0,chrIX,known_gene
89947,92788,2841,-1,0,chrIX,known_gene
80509,83041,2532,-1,0,chrIX,known_gene
69790,73453,3663,-1,0,chrIX,known_gene
61012,62728,1716,-1,0,chrIX,known_gene
57337,60694,3357,-1,0,chrIX,known_gene
53980,55021,1041,-1,0,chrIX,known_gene
46948,47542,594,-1,0,chrIX,known_gene
36898,37252,354,-1,0,chrIX,known_gene
30937,32566,1629,-1,0,chrIX,known_gene
16783,18553,1770,-1,0,chrIX,known_gene
1567,2419,852,-1,0,chrIX,known_gene
430497,432111,1614,-1,1,chrIX,known_gene
422073,422865,792,-1,1,chrIX,known_gene
415029,415617,588,-1,1,chrIX,known_gene
412035,412770,735,-1,1,chrIX,known_gene
402840,403491,651,-1,1,chrIX,known_gene
394254,394557,303,-1,1,chrIX,known_gene
389571,393675,4104,-1,1,chrIX,known_gene
377286,378246,960,-1,1,chrIX,known_gene
376647,377046,399,-1,1,chrIX,novel_orf
357414,360396,2982,-1,1,chrIX,known_gene
356142,356895,753,-1,1,chrIX,known_gene
346029,346329,300,-1,1,chrIX,novel_orf
342993,343656,663,-1,1,chrIX,known_gene
328206,332442,4236,-1,1,chrIX,known_gene
314034,314820,786,-1,1,chrIX,known_gene
308601,309171,570,-1,1,chrIX,known_gene
304476,307929,3453,-1,1,chrIX,known_gene
303678,304104,426,-1,1,chrIX,known_gene
300828,301257,429,-1,1,chrIX,known_gene
296049,300009,3960,-1,1,chrIX,known_gene
291960,292317,357,-1,1,chrIX,known_gene
290418,291669,1251,-1,1,chrIX,known_gene
281625,281934,309,-1,1,chrIX,known_gene
274071,275040,969,-1,1,chrIX,known_gene
272949,273846,897,-1,1,chrIX,known_gene
265098,265467,369,-1,1,chrIX,known_gene
261495,261873,378,-1,1,chrIX,novel_orf
246549,246915,366,-1,1,chrIX,known_gene
244656,245559,903,-1,1,chrIX,known_gene
242760,243744,984,-1,1,chrIX,known_gene
242313,242685,372,-1,1,chrIX,novel_orf
238098,240756,2658,-1,1,chrIX,known_gene
230271,231072,801,-1,1,chrIX,known_gene
222936,225597,2661,-1,1,chrIX,known_gene
202275,203259,984,-1,1,chrIX,known_gene
187989,188784,795,-1,1,chrIX,known_gene
186516,187632,1116,-1,1,chrIX,known_gene
177342,177681,339,-1,1,chrIX,known_gene
167580,169641,2061,-1,1,chrIX,known_gene
152028,152328,300,-1,1,chrIX,novel_orf
149142,149988,846,-1,1,chrIX,known_gene
136653,137877,1224,-1,1,chrIX,known_gene
134886,135360,474,-1,1,chrIX,novel_orf
121506,121821,315,-1,1,chrIX,novel_orf
98526,99135,609,-1,1,chrIX,known_gene
95064,96375,1311,-1,1,chrIX,known_gene
89229,89715,486,-1,1,chrIX,known_gene
87978,88716,738,-1,1,chrIX,known_gene
76353,77391,1038,-1,1,chrIX,known_gene
63027,68067,5040,-1,1,chrIX,known_gene
45540,45855,315,-1,1,chrIX,novel_orf
34086,34686,600,-1,1,chrIX,known_gene
33717,34077,360,-1,1,chrIX,known_gene
23118,26106,2988,-1,1,chrIX,known_gene
4965,6147,1182,-1,1,chrIX,known_gene
437042,437735,693,-1,2,chrIX,novel_orf
435272,435983,711,-1,2,chrIX,known_gene
433388,433721,333,-1,2,chrIX,known_gene
421025,421790,765,-1,2,chrIX,known_gene
406259,407642,1383,-1,2,chrIX,known_gene
397214,397949,735,-1,2,chrIX,known_gene
384917,385250,333,-1,2,chrIX,novel_orf
383555,384119,564,-1,2,chrIX,known_gene
380018,380384,366,-1,2,chrIX,known_gene
373076,374306,1230,-1,2,chrIX,known_gene
371480,371795,315,-1,2,chrIX,novel_orf
365465,369908,4443,-1,2,chrIX,known_gene
334091,334475,384,-1,2,chrIX,novel_orf
325211,325526,315,-1,2,chrIX,known_gene
322928,323237,309,-1,2,chrIX,novel_orf
313712,314051,339,-1,2,chrIX,known_gene
287789,288908,1119,-1,2,chrIX,known_gene
286067,286385,318,-1,2,chrIX,novel_orf
283028,284999,1971,-1,2,chrIX,known_gene
252041,253925,1884,-1,2,chrIX,known_gene
247901,248396,495,-1,2,chrIX,known_gene
241307,241775,468,-1,2,chrIX,known_gene
228659,229994,1335,-1,2,chrIX,known_gene
217862,220700,2838,-1,2,chrIX,known_gene
203555,204653,1098,-1,2,chrIX,known_gene
200489,202043,1554,-1,2,chrIX,known_gene
197930,199403,1473,-1,2,chrIX,known_gene
179771,180239,468,-1,2,chrIX,known_gene
174581,174887,306,-1,2,chrIX,known_gene
163277,165761,2484,-1,2,chrIX,known_gene
144326,148709,4383,-1,2,chrIX,known_gene
140612,141569,957,-1,2,chrIX,known_gene
133349,133694,345,-1,2,chrIX,novel_orf
117023,117644,621,-1,2,chrIX,known_gene
116033,116408,375,-1,2,chrIX,novel_orf
114908,115253,345,-1,2,chrIX,novel_orf
106106,113237,7131,-1,2,chrIX,known_gene
84176,84533,357,-1,2,chrIX,novel_orf
83207,83540,333,-1,2,chrIX,known_gene
74183,75773,1590,-1,2,chrIX,known_gene
59705,60011,306,-1,2,chrIX,known_gene
51758,53708,1950,-1,2,chrIX,known_gene
40190,41444,1254,-1,2,chrIX,known_gene
25259,25796,537,-1,2,chrIX,known_gene
23222,23789,567,-1,2,chrIX,known_gene
8792,9155,363,-1,2,chrIX,known_gene
482,4997,4515,-1,2,chrIX,known_gene
828,1311,483,1,0,chrX,known_gene
1611,2463,852,1,0,chrX,novel_orf
4620,5058,438,1,0,chrX,novel_orf
21972,22563,591,1,0,chrX,known_gene
26886,28596,1710,1,0,chrX,known_gene
36918,37734,816,1,0,chrX,known_gene
38004,39969,1965,1,0,chrX,known_gene
53340,54183,843,1,0,chrX,known_gene
54378,56178,1800,1,0,chrX,known_gene
60843,63489,2646,1,0,chrX,known_gene
63804,67569,3765,1,0,chrX,known_gene
78483,79107,624,1,0,chrX,novel_orf
80154,81915,1761,1,0,chrX,known_gene
85659,87495,1836,1,0,chrX,known_gene
95091,95922,831,1,0,chrX,known_gene
111720,112077,357,1,0,chrX,novel_orf
135117,135474,357,1,0,chrX,novel_orf
136173,136533,360,1,0,chrX,known_gene
140436,141138,702,1,0,chrX,known_gene
146358,146673,315,1,0,chrX,known_gene
150960,151626,666,1,0,chrX,known_gene
158187,159417,1230,1,0,chrX,known_gene
161913,164166,2253,1,0,chrX,known_gene
166464,166935,471,1,0,chrX,novel_orf
184500,185424,924,1,0,chrX,known_gene
188370,188724,354,1,0,chrX,novel_orf
199398,203325,3927,1,0,chrX,novel_orf
207876,209529,1653,1,0,chrX,known_gene
219630,219948,318,1,0,chrX,novel_orf
225054,226737,1683,1,0,chrX,known_gene
231300,233760,2460,1,0,chrX,known_gene
246300,246975,675,1,0,chrX,known_gene
247254,251691,4437,1,0,chrX,known_gene
272826,274698,1872,1,0,chrX,known_gene
281184,283380,2196,1,0,chrX,known_gene
303039,305118,2079,1,0,chrX,known_gene
313506,313812,306,1,0,chrX,novel_orf
315174,315570,396,1,0,chrX,known_gene
317283,319776,2493,1,0,chrX,known_gene
323385,324720,1335,1,0,chrX,known_gene
324963,326190,1227,1,0,chrX,known_gene
339786,342255,2469,1,0,chrX,known_gene
345972,347325,1353,1,0,chrX,known_gene
360129,360903,774,1,0,chrX,known_gene
361248,365445,4197,1,0,chrX,known_gene
367953,368373,420,1,0,chrX,known_gene
392403,393603,1200,1,0,chrX,known_gene
393966,395511,1545,1,0,chrX,known_gene
407424,407733,309,1,0,chrX,known_gene
438864,440646,1782,1,0,chrX,known_gene
462720,464253,1533,1,0,chrX,known_gene
466785,467148,363,1,0,chrX,known_gene
468000,468333,333,1,0,chrX,known_gene
480144,483612,3468,1,0,chrX,novel_orf
495105,495441,336,1,0,chrX,novel_orf
528696,529404,708,1,0,chrX,known_gene
529860,531366,1506,1,0,chrX,known_gene
536055,537549,1494,1,0,chrX,known_gene
567642,568704,1062,1,0,chrX,known_gene
578859,580221,1362,1,0,chrX,known_gene
598734,603078,4344,1,0,chrX,known_gene
623580,624603,1023,1,0,chrX,known_gene
624837,627015,2178,1,0,chrX,known_gene
627294,628326,1032,1,0,chrX,known_gene
637029,637635,606,1,0,chrX,known_gene
638319,638631,312,1,0,chrX,novel_orf
638658,639051,393,1,0,chrX,known_gene
640824,641664,840,1,0,chrX,known_gene
642006,643368,1362,1,0,chrX,known_gene
651900,652578,678,1,0,chrX,known_gene
659106,659511,405,1,0,chrX,novel_orf
661620,661935,315,1,0,chrX,novel_orf
672990,673620,630,1,0,chrX,known_gene
697140,698169,1029,1,0,chrX,known_gene
700881,701691,810,1,0,chrX,known_gene
703884,704238,354,1,0,chrX,known_gene
722814,723900,1086,1,0,chrX,known_gene
727404,728271,867,1,0,chrX,known_gene
1597,2380,783,1,1,chrX,novel_orf
2749,3085,336,1,1,chrX,novel_orf
25573,25948,375,1,1,chrX,novel_orf
42769,43246,477,1,1,chrX,novel_orf
43288,43609,321,1,1,chrX,novel_orf
69337,70879,1542,1,1,chrX,known_gene
71365,72574,1209,1,1,chrX,known_gene
84067,85336,1269,1,1,chrX,known_gene
88786,89116,330,1,1,chrX,known_gene
94048,94561,513,1,1,chrX,known_gene
105013,106072,1059,1,1,chrX,known_gene
107551,107860,309,1,1,chrX,novel_orf
117244,117787,543,1,1,chrX,known_gene
120448,121690,1242,1,1,chrX,known_gene
137122,137425,303,1,1,chrX,known_gene
145159,146044,885,1,1,chrX,known_gene
147100,147577,477,1,1,chrX,known_gene
157876,158194,318,1,1,chrX,known_gene
160618,161563,945,1,1,chrX,known_gene
173113,173413,300,1,1,chrX,novel_orf
175528,175924,396,1,1,chrX,novel_orf
189715,190243,528,1,1,chrX,known_gene
191638,192298,660,1,1,chrX,known_gene
197914,198595,681,1,1,chrX,novel_orf
221389,223327,1938,1,1,chrX,known_gene
227326,227776,450,1,1,chrX,known_gene
237262,239086,1824,1,1,chrX,known_gene
239413,241654,2241,1,1,chrX,known_gene
245590,246244,654,1,1,chrX,known_gene
257422,260947,3525,1,1,chrX,known_gene
268492,269815,1323,1,1,chrX,known_gene
314083,314434,351,1,1,chrX,known_gene
332743,333076,333,1,1,chrX,novel_orf
334264,335701,1437,1,1,chrX,known_gene
356023,357928,1905,1,1,chrX,known_gene
366676,367756,1080,1,1,chrX,known_gene
383836,386149,2313,1,1,chrX,known_gene
386347,386662,315,1,1,chrX,known_gene
407557,409162,1605,1,1,chrX,known_gene
419854,420181,327,1,1,chrX,known_gene
432643,433000,357,1,1,chrX,known_gene
436801,438610,1809,1,1,chrX,known_gene
456238,457774,1536,1,1,chrX,known_gene
460381,461593,1212,1,1,chrX,known_gene
469726,470113,387,1,1,chrX,known_gene
472759,474082,1323,1,1,chrX,novel_orf
491080,492262,1182,1,1,chrX,known_gene
503101,503485,384,1,1,chrX,known_gene
503935,507301,3366,1,1,chrX,known_gene
507745,510085,2340,1,1,chrX,known_gene
514054,516289,2235,1,1,chrX,known_gene
538771,539266,495,1,1,chrX,known_gene
548758,549814,1056,1,1,chrX,known_gene
550510,553318,2808,1,1,chrX,known_gene
555913,557602,1689,1,1,chrX,known_gene
573094,573751,657,1,1,chrX,known_gene
583732,585004,1272,1,1,chrX,known_gene
586399,586750,351,1,1,chrX,known_gene
609772,610741,969,1,1,chrX,known_gene
611194,612043,849,1,1,chrX,known_gene
612412,612931,519,1,1,chrX,known_gene
616957,617308,351,1,1,chrX,novel_orf
628711,629083,372,1,1,chrX,known_gene
647125,647476,351,1,1,chrX,known_gene
662920,663280,360,1,1,chrX,known_gene
695905,696949,1044,1,1,chrX,known_gene
704812,705115,303,1,1,chrX,known_gene
709183,709552,369,1,1,chrX,novel_orf
712516,713242,726,1,1,chrX,novel_orf
713293,714016,723,1,1,chrX,novel_orf
719665,721297,1632,1,1,chrX,known_gene
732439,734143,1704,1,1,chrX,known_gene
11474,16124,4650,1,2,chrX,known_gene
18242,18695,453,1,2,chrX,known_gene
19496,21200,1704,1,2,chrX,known_gene
23132,23729,597,1,2,chrX,known_gene
32162,33158,996,1,2,chrX,known_gene
83447,83819,372,1,2,chrX,known_gene
90785,91109,324,1,2,chrX,known_gene
97736,99467,1731,1,2,chrX,known_gene
102098,102467,369,1,2,chrX,known_gene
102977,103280,303,1,2,chrX,novel_orf
124160,124478,318,1,2,chrX,novel_orf
137378,139370,1992,1,2,chrX,known_gene
141422,141743,321,1,2,chrX,novel_orf
143291,144701,1410,1,2,chrX,known_gene
191021,191345,324,1,2,chrX,known_gene
192530,193466,936,1,2,chrX,known_gene
196286,197126,840,1,2,chrX,known_gene
198677,199157,480,1,2,chrX,novel_orf
205304,207449,2145,1,2,chrX,known_gene
214025,214391,366,1,2,chrX,novel_orf
242081,245258,3177,1,2,chrX,known_gene
259874,260204,330,1,2,chrX,known_gene
264050,264368,318,1,2,chrX,novel_orf
265925,268415,2490,1,2,chrX,known_gene
271769,272162,393,1,2,chrX,novel_orf
278840,280655,1815,1,2,chrX,known_gene
295244,298814,3570,1,2,chrX,known_gene
306131,307856,1725,1,2,chrX,known_gene
320015,322157,2142,1,2,chrX,known_gene
333356,334094,738,1,2,chrX,known_gene
335897,337037,1140,1,2,chrX,known_gene
338270,339269,999,1,2,chrX,known_gene
342521,345743,3222,1,2,chrX,known_gene
352259,353615,1356,1,2,chrX,known_gene
376661,377336,675,1,2,chrX,known_gene
378824,380096,1272,1,2,chrX,known_gene
381326,383375,2049,1,2,chrX,known_gene
387656,388247,591,1,2,chrX,known_gene
391310,391646,336,1,2,chrX,known_gene
398108,398417,309,1,2,chrX,known_gene
402896,404945,2049,1,2,chrX,known_gene
405587,407273,1686,1,2,chrX,known_gene
425156,431237,6081,1,2,chrX,known_gene
435344,435926,582,1,2,chrX,known_gene
445922,448025,2103,1,2,chrX,known_gene
449201,450665,1464,1,2,chrX,known_gene
451019,451934,915,1,2,chrX,known_gene
452429,453446,1017,1,2,chrX,known_gene
461828,462425,597,1,2,chrX,known_gene
474560,478028,3468,1,2,chrX,novel_orf
478343,479666,1323,1,2,chrX,novel_orf
496682,497009,327,1,2,chrX,known_gene
497354,500612,3258,1,2,chrX,known_gene
522047,523862,1815,1,2,chrX,known_gene
526334,526664,330,1,2,chrX,known_gene
532061,533759,1698,1,2,chrX,known_gene
534026,535751,1725,1,2,chrX,known_gene
544061,544712,651,1,2,chrX,known_gene
545786,548243,2457,1,2,chrX,known_gene
555194,555572,378,1,2,chrX,known_gene
559415,566828,7413,1,2,chrX,known_gene
569972,570284,312,1,2,chrX,novel_orf
570404,570773,369,1,2,chrX,known_gene
573980,575171,1191,1,2,chrX,known_gene
586067,586400,333,1,2,chrX,known_gene
587717,590582,2865,1,2,chrX,known_gene
615575,616286,711,1,2,chrX,known_gene
618233,619034,801,1,2,chrX,known_gene
620753,622490,1737,1,2,chrX,known_gene
630260,630581,321,1,2,chrX,novel_orf
633614,635681,2067,1,2,chrX,known_gene
639941,640451,510,1,2,chrX,known_gene
647606,649142,1536,1,2,chrX,known_gene
649775,651269,1494,1,2,chrX,known_gene
667643,669293,1650,1,2,chrX,known_gene
669521,672668,3147,1,2,chrX,known_gene
684566,689321,4755,1,2,chrX,known_gene
704195,705272,1077,1,2,chrX,known_gene
705743,706874,1131,1,2,chrX,known_gene
707159,708374,1215,1,2,chrX,known_gene
725783,726824,1041,1,2,chrX,known_gene
730514,730877,363,1,2,chrX,known_gene
736043,737117,1074,1,2,chrX,known_gene
742847,743999,1152,-1,0,chrX,known_gene
728573,729596,1023,-1,0,chrX,known_gene
714173,715397,1224,-1,0,chrX,known_gene
713516,713876,360,-1,0,chrX,known_gene
708998,709367,369,-1,0,chrX,known_gene
702026,702872,846,-1,0,chrX,known_gene
690749,695696,4947,-1,0,chrX,known_gene
689444,690524,1080,-1,0,chrX,known_gene
678956,683285,4329,-1,0,chrX,known_gene
676058,676778,720,-1,0,chrX,known_gene
658916,663059,4143,-1,0,chrX,known_gene
644303,646490,2187,-1,0,chrX,known_gene
638231,638975,744,-1,0,chrX,known_gene
604568,605651,1083,-1,0,chrX,known_gene
601358,601778,420,-1,0,chrX,novel_orf
599327,599633,306,-1,0,chrX,novel_orf
585119,585437,318,-1,0,chrX,known_gene
568805,569399,594,-1,0,chrX,known_gene
553475,554849,1374,-1,0,chrX,known_gene
526883,528476,1593,-1,0,chrX,known_gene
518762,519185,423,-1,0,chrX,known_gene
492377,496451,4074,-1,0,chrX,known_gene
471137,471671,534,-1,0,chrX,known_gene
468554,469112,558,-1,0,chrX,known_gene
467231,468281,1050,-1,0,chrX,known_gene
466520,467093,573,-1,0,chrX,known_gene
464450,466208,1758,-1,0,chrX,known_gene
460973,461345,372,-1,0,chrX,novel_orf
459794,460418,624,-1,0,chrX,known_gene
443999,444323,324,-1,0,chrX,known_gene
440993,442613,1620,-1,0,chrX,known_gene
433220,434651,1431,-1,0,chrX,known_gene
431588,432200,612,-1,0,chrX,known_gene
423137,424109,972,-1,0,chrX,known_gene
414284,414770,486,-1,0,chrX,known_gene
411233,413399,2166,-1,0,chrX,known_gene
398936,402410,3474,-1,0,chrX,known_gene
391832,392249,417,-1,0,chrX,known_gene
368747,373799,5052,-1,0,chrX,known_gene
366530,367607,1077,-1,0,chrX,novel_orf
315758,316475,717,-1,0,chrX,known_gene
315053,315557,504,-1,0,chrX,known_gene
307970,310637,2667,-1,0,chrX,known_gene
299156,302849,3693,-1,0,chrX,known_gene
294665,295061,396,-1,0,chrX,known_gene
291335,293981,2646,-1,0,chrX,known_gene
289874,290774,900,-1,0,chrX,known_gene
285557,289226,3669,-1,0,chrX,known_gene
272477,272846,369,-1,0,chrX,known_gene
247925,248315,390,-1,0,chrX,novel_orf
231581,231893,312,-1,0,chrX,novel_orf
226271,226667,396,-1,0,chrX,novel_orf
218852,220016,1164,-1,0,chrX,known_gene
209921,211577,1656,-1,0,chrX,known_gene
193859,194873,1014,-1,0,chrX,known_gene
190373,191090,717,-1,0,chrX,known_gene
188003,189440,1437,-1,0,chrX,known_gene
182297,184220,1923,-1,0,chrX,known_gene
175502,175805,303,-1,0,chrX,known_gene
175127,175502,375,-1,0,chrX,known_gene
165722,172367,6645,-1,0,chrX,known_gene
163730,164066,336,-1,0,chrX,novel_orf
153503,154691,1188,-1,0,chrX,known_gene
151712,152999,1287,-1,0,chrX,known_gene
151079,151394,315,-1,0,chrX,novel_orf
149732,150032,300,-1,0,chrX,known_gene
147818,148211,393,-1,0,chrX,known_gene
129284,130643,1359,-1,0,chrX,known_gene
122264,122948,684,-1,0,chrX,known_gene
111665,113333,1668,-1,0,chrX,known_gene
107816,108122,306,-1,0,chrX,known_gene
82094,82976,882,-1,0,chrX,known_gene
76802,79262,2460,-1,0,chrX,known_gene
74909,75302,393,-1,0,chrX,known_gene
66233,66689,456,-1,0,chrX,novel_orf
62927,63335,408,-1,0,chrX,novel_orf
62153,62564,411,-1,0,chrX,novel_orf
59855,60182,327,-1,0,chrX,known_gene
53942,54290,348,-1,0,chrX,known_gene
40193,41183,990,-1,0,chrX,known_gene
31817,32117,300,-1,0,chrX,novel_orf
26411,26771,360,-1,0,chrX,known_gene
16766,18536,1770,-1,0,chrX,known_gene
1550,2402,852,-1,0,chrX,known_gene
744910,745261,351,-1,1,chrX,known_gene
738007,739816,1809,-1,1,chrX,known_gene
686683,687025,342,-1,1,chrX,novel_orf
677440,678706,1266,-1,1,chrX,known_gene
671086,671431,345,-1,1,chrX,novel_orf
654736,655963,1227,-1,1,chrX,known_gene
652891,654238,1347,-1,1,chrX,known_gene
645523,645853,330,-1,1,chrX,known_gene
643489,644101,612,-1,1,chrX,known_gene
635854,636706,852,-1,1,chrX,known_gene
629584,632941,3357,-1,1,chrX,known_gene
622549,623014,465,-1,1,chrX,known_gene
621805,622177,372,-1,1,chrX,novel_orf
619156,619765,609,-1,1,chrX,known_gene
595060,598336,3276,-1,1,chrX,known_gene
588649,589186,537,-1,1,chrX,novel_orf
582607,583537,930,-1,1,chrX,known_gene
575353,576601,1248,-1,1,chrX,known_gene
572314,572935,621,-1,1,chrX,known_gene
569620,570598,978,-1,1,chrX,known_gene
522937,523459,522,-1,1,chrX,novel_orf
519637,521602,1965,-1,1,chrX,known_gene
516460,517513,1053,-1,1,chrX,known_gene
510238,513763,3525,-1,1,chrX,known_gene
483958,486196,2238,-1,1,chrX,known_gene
469183,469579,396,-1,1,chrX,known_gene
453682,454681,999,-1,1,chrX,known_gene
419956,421663,1707,-1,1,chrX,known_gene
409492,411040,1548,-1,1,chrX,known_gene
397354,398398,1044,-1,1,chrX,known_gene
388384,390853,2469,-1,1,chrX,known_gene
380248,381001,753,-1,1,chrX,known_gene
376798,377314,516,-1,1,chrX,novel_orf
349579,352108,2529,-1,1,chrX,known_gene
347446,348637,1191,-1,1,chrX,known_gene
344875,345220,345,-1,1,chrX,novel_orf
330430,333073,2643,-1,1,chrX,known_gene
328117,330121,2004,-1,1,chrX,known_gene
314113,314872,759,-1,1,chrX,known_gene
313015,313915,900,-1,1,chrX,known_gene
310921,312706,1785,-1,1,chrX,known_gene
298459,298876,417,-1,1,chrX,known_gene
298057,298405,348,-1,1,chrX,novel_orf
283801,285271,1470,-1,1,chrX,known_gene
274861,278002,3141,-1,1,chrX,known_gene
270001,272485,2484,-1,1,chrX,known_gene
262756,265051,2295,-1,1,chrX,known_gene
261079,262576,1497,-1,1,chrX,known_gene
234319,236356,2037,-1,1,chrX,known_gene
229024,230881,1857,-1,1,chrX,known_gene
211999,217309,5310,-1,1,chrX,known_gene
185527,186679,1152,-1,1,chrX,known_gene
178096,180103,2007,-1,1,chrX,known_gene
169150,169462,312,-1,1,chrX,known_gene
166123,166429,306,-1,1,chrX,known_gene
154984,156127,1143,-1,1,chrX,known_gene
141418,142567,1149,-1,1,chrX,known_gene
123835,126328,2493,-1,1,chrX,known_gene
117961,118825,864,-1,1,chrX,known_gene
102226,104428,2202,-1,1,chrX,known_gene
101149,101794,645,-1,1,chrX,known_gene
99703,100894,1191,-1,1,chrX,known_gene
96160,96529,369,-1,1,chrX,known_gene
89281,90097,816,-1,1,chrX,known_gene
76201,76510,309,-1,1,chrX,known_gene
72709,73414,705,-1,1,chrX,known_gene
67849,68782,933,-1,1,chrX,known_gene
56443,58813,2370,-1,1,chrX,known_gene
24340,26086,1746,-1,1,chrX,known_gene
4948,6130,1182,-1,1,chrX,known_gene
712254,715740,3486,-1,2,chrX,known_gene
708810,709707,897,-1,2,chrX,known_gene
698325,700614,2289,-1,2,chrX,known_gene
673728,675852,2124,-1,2,chrX,known_gene
665217,667137,1920,-1,2,chrX,known_gene
663999,665019,1020,-1,2,chrX,known_gene
656253,658689,2436,-1,2,chrX,known_gene
616350,617334,984,-1,2,chrX,known_gene
613185,615156,1971,-1,2,chrX,known_gene
603219,604203,984,-1,2,chrX,known_gene
590871,594327,3456,-1,2,chrX,known_gene
586494,587373,879,-1,2,chrX,known_gene
581913,582255,342,-1,2,chrX,known_gene
580431,581616,1185,-1,2,chrX,known_gene
577254,578190,936,-1,2,chrX,known_gene
570966,572124,1158,-1,2,chrX,known_gene
567018,567444,426,-1,2,chrX,known_gene
557808,559158,1350,-1,2,chrX,known_gene
552543,552858,315,-1,2,chrX,novel_orf
549114,549558,444,-1,2,chrX,novel_orf
544731,545175,444,-1,2,chrX,known_gene
541791,542502,711,-1,2,chrX,known_gene
524907,525381,474,-1,2,chrX,known_gene
508068,508380,312,-1,2,chrX,novel_orf
503709,504072,363,-1,2,chrX,known_gene
500712,503391,2679,-1,2,chrX,known_gene
486585,490812,4227,-1,2,chrX,known_gene
470229,470964,735,-1,2,chrX,known_gene
469803,470205,402,-1,2,chrX,known_gene
458640,459426,786,-1,2,chrX,known_gene
442908,444861,1953,-1,2,chrX,known_gene
422697,423012,315,-1,2,chrX,known_gene
417561,419562,2001,-1,2,chrX,known_gene
386367,387240,873,-1,2,chrX,known_gene
375114,375774,660,-1,2,chrX,known_gene
358299,359676,1377,-1,2,chrX,known_gene
326241,327873,1632,-1,2,chrX,known_gene
305220,305862,642,-1,2,chrX,known_gene
269100,269559,459,-1,2,chrX,novel_orf
254736,256812,2076,-1,2,chrX,known_gene
251820,254442,2622,-1,2,chrX,known_gene
237600,237954,354,-1,2,chrX,novel_orf
217704,218856,1152,-1,2,chrX,known_gene
191571,191895,324,-1,2,chrX,known_gene
187125,187644,519,-1,2,chrX,known_gene
173598,177306,3708,-1,2,chrX,known_gene
164277,165348,1071,-1,2,chrX,known_gene
147966,150390,2424,-1,2,chrX,known_gene
136371,136773,402,-1,2,chrX,known_gene
134331,135999,1668,-1,2,chrX,known_gene
131100,133935,2835,-1,2,chrX,known_gene
126852,128952,2100,-1,2,chrX,known_gene
113877,115629,1752,-1,2,chrX,known_gene
111876,112185,309,-1,2,chrX,known_gene
109965,111159,1194,-1,2,chrX,known_gene
106893,109461,2568,-1,2,chrX,known_gene
92052,94530,2478,-1,2,chrX,known_gene
87582,88560,978,-1,2,chrX,known_gene
85434,85752,318,-1,2,chrX,known_gene
81252,81711,459,-1,2,chrX,novel_orf
69240,69942,702,-1,2,chrX,known_gene
50628,53151,2523,-1,2,chrX,known_gene
47658,49935,2277,-1,2,chrX,known_gene
41388,47433,6045,-1,2,chrX,known_gene
36756,37200,444,-1,2,chrX,known_gene
33849,36249,2400,-1,2,chrX,known_gene
25452,25752,300,-1,2,chrX,known_gene
8775,9138,363,-1,2,chrX,known_gene
465,4980,4515,-1,2,chrX,known_gene
450,798,348,1,0,chrXI,known_gene
2388,2721,333,1,0,chrXI,known_gene
14484,15708,1224,1,0,chrXI,known_gene
22233,24084,1851,1,0,chrXI,known_gene
34542,36414,1872,1,0,chrXI,known_gene
39162,42237,3075,1,0,chrXI,known_gene
43641,44025,384,1,0,chrXI,novel_orf
53703,55602,1899,1,0,chrXI,known_gene
83112,83550,438,1,0,chrXI,known_gene
89481,89787,306,1,0,chrXI,novel_orf
96756,98157,1401,1,0,chrXI,known_gene
104358,104715,357,1,0,chrXI,known_gene
155646,158232,2586,1,0,chrXI,known_gene
163599,164109,510,1,0,chrXI,known_gene
196743,197076,333,1,0,chrXI,novel_orf
220323,220974,651,1,0,chrXI,known_gene
226569,228765,2196,1,0,chrXI,known_gene
240648,240951,303,1,0,chrXI,novel_orf
248919,253476,4557,1,0,chrXI,known_gene
267678,267981,303,1,0,chrXI,novel_orf
273393,275043,1650,1,0,chrXI,known_gene
278280,278664,384,1,0,chrXI,known_gene
280920,281535,615,1,0,chrXI,known_gene
286602,288573,1971,1,0,chrXI,known_gene
306210,306720,510,1,0,chrXI,known_gene
307284,307827,543,1,0,chrXI,known_gene
314811,315273,462,1,0,chrXI,known_gene
317763,320673,2910,1,0,chrXI,known_gene
325770,326112,342,1,0,chrXI,known_gene
330165,330534,369,1,0,chrXI,known_gene
343479,343938,459,1,0,chrXI,novel_orf
365604,369117,3513,1,0,chrXI,known_gene
382071,382485,414,1,0,chrXI,known_gene
382497,383103,606,1,0,chrXI,known_gene
386397,386706,309,1,0,chrXI,known_gene
387561,388905,1344,1,0,chrXI,known_gene
391869,392217,348,1,0,chrXI,novel_orf
393720,394554,834,1,0,chrXI,known_gene
400920,401256,336,1,0,chrXI,novel_orf
402567,403518,951,1,0,chrXI,known_gene
408543,411483,2940,1,0,chrXI,known_gene
435579,436785,1206,1,0,chrXI,known_gene
438825,439350,525,1,0,chrXI,novel_orf
445380,446727,1347,1,0,chrXI,known_gene
448782,449172,390,1,0,chrXI,novel_orf
469716,471339,1623,1,0,chrXI,known_gene
494256,497358,3102,1,0,chrXI,known_gene
525900,526302,402,1,0,chrXI,novel_orf
527814,530484,2670,1,0,chrXI,known_gene
537939,538296,357,1,0,chrXI,novel_orf
544212,544527,315,1,0,chrXI,novel_orf
547425,547788,363,1,0,chrXI,novel_orf
549447,551367,1920,1,0,chrXI,known_gene
557676,558954,1278,1,0,chrXI,known_gene
559665,560652,987,1,0,chrXI,known_gene
571611,573393,1782,1,0,chrXI,known_gene
573573,574632,1059,1,0,chrXI,known_gene
582282,583395,1113,1,0,chrXI,known_gene
590394,591357,963,1,0,chrXI,known_gene
592824,596298,3474,1,0,chrXI,known_gene
599856,603072,3216,1,0,chrXI,known_gene
615729,617535,1806,1,0,chrXI,known_gene
635850,638286,2436,1,0,chrXI,known_gene
640467,642504,2037,1,0,chrXI,known_gene
653079,656736,3657,1,0,chrXI,known_gene
656835,657756,921,1,0,chrXI,known_gene
6106,7528,1422,1,1,chrXI,known_gene
48106,48955,849,1,1,chrXI,known_gene
50050,53353,3303,1,1,chrXI,known_gene
63820,64402,582,1,1,chrXI,known_gene
75748,77032,1284,1,1,chrXI,known_gene
81034,82639,1605,1,1,chrXI,known_gene
84703,85903,1200,1,1,chrXI,known_gene
94498,96265,1767,1,1,chrXI,known_gene
114355,114694,339,1,1,chrXI,known_gene
118792,120304,1512,1,1,chrXI,known_gene
125758,127042,1284,1,1,chrXI,known_gene
127474,130261,2787,1,1,chrXI,known_gene
130633,131050,417,1,1,chrXI,known_gene
144400,145378,978,1,1,chrXI,known_gene
153268,153706,438,1,1,chrXI,known_gene
154990,155293,303,1,1,chrXI,known_gene
158617,159007,390,1,1,chrXI,known_gene
166543,167452,909,1,1,chrXI,known_gene
169534,169936,402,1,1,chrXI,novel_orf
180778,182425,1647,1,1,chrXI,known_gene
185956,186292,336,1,1,chrXI,known_gene
186415,186814,399,1,1,chrXI,known_gene
188071,188377,306,1,1,chrXI,novel_orf
208246,210130,1884,1,1,chrXI,known_gene
210592,212332,1740,1,1,chrXI,known_gene
214141,216700,2559,1,1,chrXI,known_gene
236140,237070,930,1,1,chrXI,known_gene
237535,238891,1356,1,1,chrXI,known_gene
262276,263113,837,1,1,chrXI,known_gene
283528,284455,927,1,1,chrXI,known_gene
288844,291052,2208,1,1,chrXI,known_gene
299581,301882,2301,1,1,chrXI,known_gene
305113,305884,771,1,1,chrXI,known_gene
310198,313078,2880,1,1,chrXI,known_gene
315280,315724,444,1,1,chrXI,known_gene
319435,319759,324,1,1,chrXI,known_gene
323227,325120,1893,1,1,chrXI,known_gene
339571,339946,375,1,1,chrXI,known_gene
341311,342373,1062,1,1,chrXI,known_gene
349462,351013,1551,1,1,chrXI,known_gene
358474,359566,1092,1,1,chrXI,known_gene
360142,360817,675,1,1,chrXI,known_gene
369364,369721,357,1,1,chrXI,known_gene
404101,405091,990,1,1,chrXI,known_gene
408898,409201,303,1,1,chrXI,known_gene
416173,416560,387,1,1,chrXI,novel_orf
418309,420061,1752,1,1,chrXI,known_gene
426241,426952,711,1,1,chrXI,known_gene
429301,430108,807,1,1,chrXI,known_gene
438088,438544,456,1,1,chrXI,known_gene
452200,454078,1878,1,1,chrXI,known_gene
479233,481981,2748,1,1,chrXI,known_gene
483418,485011,1593,1,1,chrXI,known_gene
496651,497221,570,1,1,chrXI,known_gene
497233,497554,321,1,1,chrXI,known_gene
498424,498727,303,1,1,chrXI,novel_orf
500281,501103,822,1,1,chrXI,known_gene
505813,506125,312,1,1,chrXI,novel_orf
509836,510208,372,1,1,chrXI,novel_orf
515062,516871,1809,1,1,chrXI,known_gene
518197,518950,753,1,1,chrXI,known_gene
519271,520624,1353,1,1,chrXI,known_gene
525256,525562,306,1,1,chrXI,known_gene
534292,534664,372,1,1,chrXI,novel_orf
548215,549091,876,1,1,chrXI,known_gene
552763,554620,1857,1,1,chrXI,known_gene
554986,556174,1188,1,1,chrXI,known_gene
562546,565138,2592,1,1,chrXI,known_gene
579208,579676,468,1,1,chrXI,known_gene
597088,597391,303,1,1,chrXI,novel_orf
611524,612265,741,1,1,chrXI,known_gene
619804,625432,5628,1,1,chrXI,known_gene
639493,639826,333,1,1,chrXI,novel_orf
661441,663289,1848,1,1,chrXI,known_gene
25214,26159,945,1,2,chrXI,known_gene
47156,47972,816,1,2,chrXI,known_gene
68615,69011,396,1,2,chrXI,novel_orf
98720,99641,921,1,2,chrXI,known_gene
100670,106826,6156,1,2,chrXI,known_gene
107315,108599,1284,1,2,chrXI,known_gene
109268,109613,345,1,2,chrXI,known_gene
122516,125543,3027,1,2,chrXI,known_gene
161600,162335,735,1,2,chrXI,known_gene
171782,173861,2079,1,2,chrXI,known_gene
174212,175616,1404,1,2,chrXI,known_gene
176780,178172,1392,1,2,chrXI,known_gene
178514,179174,660,1,2,chrXI,known_gene
179666,180263,597,1,2,chrXI,known_gene
182957,184544,1587,1,2,chrXI,known_gene
194477,194999,522,1,2,chrXI,known_gene
196817,197171,354,1,2,chrXI,novel_orf
203540,205253,1713,1,2,chrXI,known_gene
205706,207749,2043,1,2,chrXI,known_gene
212042,212423,381,1,2,chrXI,known_gene
217343,218318,975,1,2,chrXI,known_gene
219125,219437,312,1,2,chrXI,known_gene
232226,233891,1665,1,2,chrXI,known_gene
234425,235787,1362,1,2,chrXI,known_gene
256769,257843,1074,1,2,chrXI,known_gene
261131,261851,720,1,2,chrXI,known_gene
263348,264290,942,1,2,chrXI,known_gene
264788,265808,1020,1,2,chrXI,known_gene
271877,273209,1332,1,2,chrXI,known_gene
275282,276998,1716,1,2,chrXI,known_gene
279122,280127,1005,1,2,chrXI,known_gene
280508,280859,351,1,2,chrXI,known_gene
285029,286208,1179,1,2,chrXI,known_gene
291452,292631,1179,1,2,chrXI,known_gene
296429,299075,2646,1,2,chrXI,known_gene
328175,328643,468,1,2,chrXI,novel_orf
353492,355079,1587,1,2,chrXI,known_gene
356321,356642,321,1,2,chrXI,known_gene
356747,357848,1101,1,2,chrXI,known_gene
362621,364193,1572,1,2,chrXI,known_gene
369890,371390,1500,1,2,chrXI,known_gene
371828,374105,2277,1,2,chrXI,known_gene
374504,375215,711,1,2,chrXI,known_gene
375455,378572,3117,1,2,chrXI,known_gene
385757,387206,1449,1,2,chrXI,known_gene
420443,420893,450,1,2,chrXI,novel_orf
421898,422336,438,1,2,chrXI,novel_orf
443231,444938,1707,1,2,chrXI,known_gene
451433,451988,555,1,2,chrXI,known_gene
463958,464948,990,1,2,chrXI,known_gene
478337,478832,495,1,2,chrXI,known_gene
487769,488618,849,1,2,chrXI,known_gene
491363,493661,2298,1,2,chrXI,known_gene
505508,505814,306,1,2,chrXI,novel_orf
506516,506831,315,1,2,chrXI,known_gene
506897,507707,810,1,2,chrXI,known_gene
507938,508553,615,1,2,chrXI,known_gene
520352,520652,300,1,2,chrXI,known_gene
522014,523346,1332,1,2,chrXI,known_gene
523571,523955,384,1,2,chrXI,novel_orf
530945,532202,1257,1,2,chrXI,known_gene
556517,557342,825,1,2,chrXI,known_gene
561062,561374,312,1,2,chrXI,novel_orf
567917,570149,2232,1,2,chrXI,known_gene
576440,576797,357,1,2,chrXI,novel_orf
583652,584744,1092,1,2,chrXI,known_gene
584951,586709,1758,1,2,chrXI,known_gene
608945,611066,2121,1,2,chrXI,known_gene
612926,613301,375,1,2,chrXI,novel_orf
626792,630380,3588,1,2,chrXI,known_gene
631151,632801,1650,1,2,chrXI,known_gene
646355,649865,3510,1,2,chrXI,known_gene
662148,662523,375,-1,0,chrXI,novel_orf
612930,613515,585,-1,0,chrXI,known_gene
604404,605418,1014,-1,0,chrXI,known_gene
597054,598890,1836,-1,0,chrXI,known_gene
586788,589305,2517,-1,0,chrXI,known_gene
570327,570909,582,-1,0,chrXI,known_gene
566112,567198,1086,-1,0,chrXI,known_gene
534066,535281,1215,-1,0,chrXI,known_gene
520896,521712,816,-1,0,chrXI,known_gene
519642,519951,309,-1,0,chrXI,novel_orf
515145,515463,318,-1,0,chrXI,novel_orf
511998,513264,1266,-1,0,chrXI,known_gene
510909,511797,888,-1,0,chrXI,known_gene
508701,510681,1980,-1,0,chrXI,known_gene
497577,499833,2256,-1,0,chrXI,known_gene
471693,473349,1656,-1,0,chrXI,known_gene
465366,466071,705,-1,0,chrXI,known_gene
461634,462696,1062,-1,0,chrXI,known_gene
455145,455496,351,-1,0,chrXI,known_gene
440607,442722,2115,-1,0,chrXI,known_gene
433092,434877,1785,-1,0,chrXI,known_gene
425487,425790,303,-1,0,chrXI,known_gene
417507,418023,516,-1,0,chrXI,known_gene
411618,416913,5295,-1,0,chrXI,known_gene
405189,407241,2052,-1,0,chrXI,known_gene
394725,397248,2523,-1,0,chrXI,known_gene
389379,389883,504,-1,0,chrXI,known_gene
380064,381858,1794,-1,0,chrXI,known_gene
358584,358905,321,-1,0,chrXI,novel_orf
346074,346764,690,-1,0,chrXI,known_gene
330855,333969,3114,-1,0,chrXI,known_gene
328785,329169,384,-1,0,chrXI,known_gene
310416,310761,345,-1,0,chrXI,novel_orf
294609,296193,1584,-1,0,chrXI,known_gene
277188,277863,675,-1,0,chrXI,known_gene
274221,274737,516,-1,0,chrXI,novel_orf
248061,248367,306,-1,0,chrXI,known_gene
243219,245373,2154,-1,0,chrXI,known_gene
239184,242583,3399,-1,0,chrXI,known_gene
226833,227250,417,-1,0,chrXI,novel_orf
221343,222900,1557,-1,0,chrXI,known_gene
206985,207297,312,-1,0,chrXI,novel_orf
200883,201771,888,-1,0,chrXI,known_gene
189123,191442,2319,-1,0,chrXI,known_gene
186459,188640,2181,-1,0,chrXI,known_gene
175842,176481,639,-1,0,chrXI,known_gene
169206,171129,1923,-1,0,chrXI,known_gene
164916,165930,1014,-1,0,chrXI,known_gene
163641,164385,744,-1,0,chrXI,known_gene
149385,150687,1302,-1,0,chrXI,known_gene
137931,140691,2760,-1,0,chrXI,known_gene
134508,135705,1197,-1,0,chrXI,known_gene
123900,124227,327,-1,0,chrXI,novel_orf
113214,114627,1413,-1,0,chrXI,known_gene
110463,112503,2040,-1,0,chrXI,known_gene
89283,91536,2253,-1,0,chrXI,known_gene
74931,75534,603,-1,0,chrXI,known_gene
49005,49809,804,-1,0,chrXI,known_gene
48171,48573,402,-1,0,chrXI,novel_orf
31959,34107,2148,-1,0,chrXI,known_gene
26826,30687,3861,-1,0,chrXI,known_gene
17358,18339,981,-1,0,chrXI,known_gene
9090,11226,2136,-1,0,chrXI,known_gene
1809,2181,372,-1,0,chrXI,known_gene
658715,660464,1749,-1,1,chrXI,known_gene
653606,653987,381,-1,1,chrXI,novel_orf
638900,639968,1068,-1,1,chrXI,known_gene
603194,604232,1038,-1,1,chrXI,known_gene
601844,602288,444,-1,1,chrXI,novel_orf
599093,599681,588,-1,1,chrXI,known_gene
596420,596822,402,-1,1,chrXI,known_gene
578186,578507,321,-1,1,chrXI,known_gene
576434,578123,1689,-1,1,chrXI,known_gene
572975,573335,360,-1,1,chrXI,novel_orf
572399,572741,342,-1,1,chrXI,novel_orf
571682,572183,501,-1,1,chrXI,novel_orf
565298,565892,594,-1,1,chrXI,known_gene
535646,547925,12279,-1,1,chrXI,known_gene
528185,528557,372,-1,1,chrXI,novel_orf
526829,527231,402,-1,1,chrXI,known_gene
525386,526640,1254,-1,1,chrXI,known_gene
524222,525074,852,-1,1,chrXI,known_gene
450422,451250,828,-1,1,chrXI,known_gene
448520,449864,1344,-1,1,chrXI,known_gene
446798,447677,879,-1,1,chrXI,known_gene
438776,439385,609,-1,1,chrXI,known_gene
437096,437492,396,-1,1,chrXI,known_gene
408662,408962,300,-1,1,chrXI,novel_orf
398831,402080,3249,-1,1,chrXI,known_gene
397343,398750,1407,-1,1,chrXI,known_gene
392525,393140,615,-1,1,chrXI,known_gene
390239,392279,2040,-1,1,chrXI,known_gene
388166,388487,321,-1,1,chrXI,novel_orf
387818,388121,303,-1,1,chrXI,novel_orf
382715,384725,2010,-1,1,chrXI,known_gene
369527,369920,393,-1,1,chrXI,known_gene
347213,349136,1923,-1,1,chrXI,known_gene
342851,345620,2769,-1,1,chrXI,known_gene
336536,338753,2217,-1,1,chrXI,known_gene
321014,321518,504,-1,1,chrXI,known_gene
316436,317057,621,-1,1,chrXI,known_gene
292955,294308,1353,-1,1,chrXI,known_gene
281024,282329,1305,-1,1,chrXI,known_gene
275651,275954,303,-1,1,chrXI,novel_orf
274445,274760,315,-1,1,chrXI,novel_orf
269717,270650,933,-1,1,chrXI,known_gene
266144,269459,3315,-1,1,chrXI,known_gene
255719,256472,753,-1,1,chrXI,known_gene
246137,247682,1545,-1,1,chrXI,known_gene
228938,229880,942,-1,1,chrXI,known_gene
224726,225875,1149,-1,1,chrXI,known_gene
195287,196028,741,-1,1,chrXI,known_gene
191678,193070,1392,-1,1,chrXI,known_gene
185285,185681,396,-1,1,chrXI,known_gene
159455,161342,1887,-1,1,chrXI,known_gene
153815,154451,636,-1,1,chrXI,known_gene
147629,148838,1209,-1,1,chrXI,known_gene
119282,119747,465,-1,1,chrXI,novel_orf
115499,117986,2487,-1,1,chrXI,known_gene
80159,80537,378,-1,1,chrXI,known_gene
70733,73865,3132,-1,1,chrXI,known_gene
68231,70220,1989,-1,1,chrXI,known_gene
63929,67466,3537,-1,1,chrXI,known_gene
55934,63359,7425,-1,1,chrXI,known_gene
42422,46295,3873,-1,1,chrXI,known_gene
36698,38153,1455,-1,1,chrXI,known_gene
633025,635179,2154,-1,2,chrXI,known_gene
612664,613885,1221,-1,2,chrXI,known_gene
605632,608365,2733,-1,2,chrXI,known_gene
591505,592540,1035,-1,2,chrXI,known_gene
583813,584113,300,-1,2,chrXI,novel_orf
579826,580750,924,-1,2,chrXI,known_gene
574933,575980,1047,-1,2,chrXI,known_gene
560788,562297,1509,-1,2,chrXI,known_gene
532549,533464,915,-1,2,chrXI,known_gene
523417,523993,576,-1,2,chrXI,known_gene
518062,518566,504,-1,2,chrXI,known_gene
507919,508561,642,-1,2,chrXI,known_gene
506878,507304,426,-1,2,chrXI,known_gene
501343,506395,5052,-1,2,chrXI,known_gene
488737,489655,918,-1,2,chrXI,known_gene
485143,487372,2229,-1,2,chrXI,known_gene
482170,483139,969,-1,2,chrXI,known_gene
476215,478063,1848,-1,2,chrXI,known_gene
473722,475900,2178,-1,2,chrXI,known_gene
466960,468667,1707,-1,2,chrXI,known_gene
463738,464116,378,-1,2,chrXI,known_gene
458923,461239,2316,-1,2,chrXI,known_gene
454351,457054,2703,-1,2,chrXI,known_gene
427294,428551,1257,-1,2,chrXI,known_gene
421423,425875,4452,-1,2,chrXI,known_gene
420154,421216,1062,-1,2,chrXI,known_gene
407464,407989,525,-1,2,chrXI,known_gene
403579,403879,300,-1,2,chrXI,known_gene
386836,387187,351,-1,2,chrXI,novel_orf
376300,376639,339,-1,2,chrXI,novel_orf
361057,361828,771,-1,2,chrXI,known_gene
351274,352624,1350,-1,2,chrXI,known_gene
339667,340546,879,-1,2,chrXI,known_gene
337039,337711,672,-1,2,chrXI,known_gene
335320,336157,837,-1,2,chrXI,known_gene
334411,334915,504,-1,2,chrXI,known_gene
328117,329443,1326,-1,2,chrXI,known_gene
326407,327487,1080,-1,2,chrXI,known_gene
298579,299056,477,-1,2,chrXI,novel_orf
297199,297526,327,-1,2,chrXI,novel_orf
292837,293221,384,-1,2,chrXI,known_gene
276307,276619,312,-1,2,chrXI,novel_orf
258502,258913,411,-1,2,chrXI,known_gene
257149,257650,501,-1,2,chrXI,novel_orf
253696,255460,1764,-1,2,chrXI,known_gene
228463,228799,336,-1,2,chrXI,known_gene
223351,224455,1104,-1,2,chrXI,known_gene
222892,223285,393,-1,2,chrXI,known_gene
218569,219217,648,-1,2,chrXI,known_gene
212494,212998,504,-1,2,chrXI,known_gene
196348,200167,3819,-1,2,chrXI,known_gene
193573,194866,1293,-1,2,chrXI,known_gene
171550,172168,618,-1,2,chrXI,known_gene
167611,168829,1218,-1,2,chrXI,known_gene
141793,142819,1026,-1,2,chrXI,known_gene
133720,134134,414,-1,2,chrXI,known_gene
131287,133492,2205,-1,2,chrXI,known_gene
130684,131068,384,-1,2,chrXI,known_gene
120379,122236,1857,-1,2,chrXI,known_gene
92743,93298,555,-1,2,chrXI,known_gene
86224,88786,2562,-1,2,chrXI,known_gene
78865,79882,1017,-1,2,chrXI,known_gene
77257,78646,1389,-1,2,chrXI,known_gene
68536,68902,366,-1,2,chrXI,known_gene
31081,31693,612,-1,2,chrXI,known_gene
3502,5620,2118,-1,2,chrXI,known_gene
1611,2226,615,1,0,chrXII,novel_orf
2595,2931,336,1,0,chrXII,novel_orf
7254,7761,507,1,0,chrXII,novel_orf
8130,8466,336,1,0,chrXII,novel_orf
17955,19707,1752,1,0,chrXII,known_gene
23568,25296,1728,1,0,chrXII,known_gene
30108,31704,1596,1,0,chrXII,known_gene
40665,41205,540,1,0,chrXII,known_gene
46671,47055,384,1,0,chrXII,known_gene
47976,48402,426,1,0,chrXII,known_gene
66561,66942,381,1,0,chrXII,known_gene
87402,88155,753,1,0,chrXII,known_gene
94746,95121,375,1,0,chrXII,known_gene
96813,97461,648,1,0,chrXII,novel_orf
112233,112545,312,1,0,chrXII,novel_orf
141072,142923,1851,1,0,chrXII,known_gene
164391,165402,1011,1,0,chrXII,known_gene
166536,167136,600,1,0,chrXII,known_gene
194451,195174,723,1,0,chrXII,known_gene
203289,204081,792,1,0,chrXII,known_gene
204990,208500,3510,1,0,chrXII,known_gene
247200,247953,753,1,0,chrXII,known_gene
253860,254958,1098,1,0,chrXII,known_gene
260004,260355,351,1,0,chrXII,novel_orf
264156,265254,1098,1,0,chrXII,known_gene
265455,266277,822,1,0,chrXII,known_gene
266547,266868,321,1,0,chrXII,novel_orf
267168,267723,555,1,0,chrXII,known_gene
273459,273834,375,1,0,chrXII,novel_orf
290211,291936,1725,1,0,chrXII,known_gene
307371,307725,354,1,0,chrXII,novel_orf
308295,308598,303,1,0,chrXII,novel_orf
310788,311088,300,1,0,chrXII,novel_orf
311109,311433,324,1,0,chrXII,novel_orf
320700,322080,1380,1,0,chrXII,known_gene
322296,323178,882,1,0,chrXII,known_gene
332589,336033,3444,1,0,chrXII,known_gene
346584,346980,396,1,0,chrXII,known_gene
369642,370104,462,1,0,chrXII,novel_orf
371619,372927,1308,1,0,chrXII,known_gene
385533,386175,642,1,0,chrXII,known_gene
391599,391944,345,1,0,chrXII,known_gene
393483,393894,411,1,0,chrXII,known_gene
408444,410193,1749,1,0,chrXII,known_gene
413280,415527,2247,1,0,chrXII,known_gene
434640,437397,2757,1,0,chrXII,known_gene
440466,441288,822,1,0,chrXII,known_gene
454695,455070,375,1,0,chrXII,known_gene
465987,466338,351,1,0,chrXII,novel_orf
500334,500688,354,1,0,chrXII,known_gene
506133,507585,1452,1,0,chrXII,known_gene
511053,512940,1887,1,0,chrXII,known_gene
522105,522453,348,1,0,chrXII,known_gene
532668,533055,387,1,0,chrXII,novel_orf
546096,547611,1515,1,0,chrXII,known_gene
554577,556419,1842,1,0,chrXII,known_gene
568566,570627,2061,1,0,chrXII,known_gene
589353,590541,1188,1,0,chrXII,known_gene
607455,607983,528,1,0,chrXII,novel_orf
612366,614163,1797,1,0,chrXII,known_gene
614754,616191,1437,1,0,chrXII,known_gene
617532,620160,2628,1,0,chrXII,known_gene
620472,622821,2349,1,0,chrXII,known_gene
627117,628197,1080,1,0,chrXII,known_gene
634251,636084,1833,1,0,chrXII,known_gene
641463,642057,594,1,0,chrXII,known_gene
652917,653385,468,1,0,chrXII,novel_orf
680199,680844,645,1,0,chrXII,known_gene
691554,693882,2328,1,0,chrXII,known_gene
730824,731559,735,1,0,chrXII,known_gene
747936,748875,939,1,0,chrXII,known_gene
765654,766089,435,1,0,chrXII,known_gene
771939,776304,4365,1,0,chrXII,known_gene
777627,777942,315,1,0,chrXII,known_gene
779214,780786,1572,1,0,chrXII,known_gene
804345,805203,858,1,0,chrXII,known_gene
807384,808818,1434,1,0,chrXII,known_gene
816093,817761,1668,1,0,chrXII,known_gene
827520,828027,507,1,0,chrXII,known_gene
828729,829380,651,1,0,chrXII,known_gene
834351,836163,1812,1,0,chrXII,known_gene
844281,845730,1449,1,0,chrXII,known_gene
846102,847422,1320,1,0,chrXII,known_gene
854061,854391,330,1,0,chrXII,known_gene
855198,855531,333,1,0,chrXII,known_gene
855537,855843,306,1,0,chrXII,known_gene
859551,861525,1974,1,0,chrXII,known_gene
862713,866784,4071,1,0,chrXII,known_gene
876921,877296,375,1,0,chrXII,known_gene
903723,904440,717,1,0,chrXII,known_gene
916227,916614,387,1,0,chrXII,novel_orf
919920,920274,354,1,0,chrXII,novel_orf
922062,922536,474,1,0,chrXII,known_gene
923487,923802,315,1,0,chrXII,novel_orf
982893,986817,3924,1,0,chrXII,known_gene
987612,988113,501,1,0,chrXII,known_gene
1006245,1006995,750,1,0,chrXII,known_gene
1012500,1013775,1275,1,0,chrXII,known_gene
1024188,1024593,405,1,0,chrXII,known_gene
1030833,1032012,1179,1,0,chrXII,known_gene
1036092,1038753,2661,1,0,chrXII,known_gene
1043997,1051884,7887,1,0,chrXII,known_gene
1062918,1063281,363,1,0,chrXII,known_gene
11725,12076,351,1,1,chrXII,known_gene
54688,55030,342,1,1,chrXII,novel_orf
56368,56974,606,1,1,chrXII,novel_orf
72097,72469,372,1,1,chrXII,novel_orf
73408,74101,693,1,1,chrXII,known_gene
81460,83710,2250,1,1,chrXII,known_gene
112846,115993,3147,1,1,chrXII,novel_orf
116431,121111,4680,1,1,chrXII,known_gene
121321,121648,327,1,1,chrXII,known_gene
125533,127255,1722,1,1,chrXII,known_gene
127522,128992,1470,1,1,chrXII,known_gene
131728,133987,2259,1,1,chrXII,known_gene
136585,137866,1281,1,1,chrXII,known_gene
143200,146041,2841,1,1,chrXII,known_gene
146290,147601,1311,1,1,chrXII,known_gene
147889,150163,2274,1,1,chrXII,known_gene
160048,161434,1386,1,1,chrXII,known_gene
169102,169678,576,1,1,chrXII,known_gene
172936,173320,384,1,1,chrXII,novel_orf
177607,178621,1014,1,1,chrXII,known_gene
182272,182596,324,1,1,chrXII,novel_orf
183622,184162,540,1,1,chrXII,known_gene
251806,252130,324,1,1,chrXII,novel_orf
274426,274795,369,1,1,chrXII,novel_orf
286819,287674,855,1,1,chrXII,known_gene
302242,306499,4257,1,1,chrXII,known_gene
328033,328357,324,1,1,chrXII,novel_orf
328360,328690,330,1,1,chrXII,novel_orf
329938,330388,450,1,1,chrXII,novel_orf
338140,338461,321,1,1,chrXII,novel_orf
341809,342853,1044,1,1,chrXII,known_gene
350566,351196,630,1,1,chrXII,novel_orf
356953,357463,510,1,1,chrXII,novel_orf
370390,370723,333,1,1,chrXII,known_gene
380821,382252,1431,1,1,chrXII,known_gene
399028,399433,405,1,1,chrXII,known_gene
410722,412414,1692,1,1,chrXII,known_gene
423682,424774,1092,1,1,chrXII,known_gene
425185,426616,1431,1,1,chrXII,known_gene
456850,457201,351,1,1,chrXII,novel_orf
485344,485689,345,1,1,chrXII,known_gene
493882,494389,507,1,1,chrXII,known_gene
498946,499405,459,1,1,chrXII,known_gene
502420,504247,1827,1,1,chrXII,known_gene
517939,520351,2412,1,1,chrXII,known_gene
535213,536689,1476,1,1,chrXII,known_gene
537271,538432,1161,1,1,chrXII,known_gene
543967,545698,1731,1,1,chrXII,known_gene
555382,555718,336,1,1,chrXII,known_gene
572908,573232,324,1,1,chrXII,known_gene
574150,576337,2187,1,1,chrXII,known_gene
593437,594760,1323,1,1,chrXII,novel_orf
604573,604879,306,1,1,chrXII,known_gene
606829,607177,348,1,1,chrXII,known_gene
624202,625021,819,1,1,chrXII,known_gene
641956,642262,306,1,1,chrXII,known_gene
646414,650923,4509,1,1,chrXII,known_gene
658825,659791,966,1,1,chrXII,known_gene
660715,662833,2118,1,1,chrXII,known_gene
670339,672823,2484,1,1,chrXII,known_gene
678211,679924,1713,1,1,chrXII,known_gene
704308,704698,390,1,1,chrXII,known_gene
707359,708145,786,1,1,chrXII,known_gene
722977,723304,327,1,1,chrXII,known_gene
732541,733876,1335,1,1,chrXII,known_gene
752953,753358,405,1,1,chrXII,novel_orf
782173,782896,723,1,1,chrXII,known_gene
784912,786118,1206,1,1,chrXII,known_gene
786730,787333,603,1,1,chrXII,known_gene
787663,789679,2016,1,1,chrXII,known_gene
790675,791806,1131,1,1,chrXII,known_gene
820510,822040,1530,1,1,chrXII,known_gene
826093,826393,300,1,1,chrXII,novel_orf
831115,833539,2424,1,1,chrXII,known_gene
841330,844000,2670,1,1,chrXII,known_gene
849802,852019,2217,1,1,chrXII,known_gene
857539,859336,1797,1,1,chrXII,known_gene
871696,872728,1032,1,1,chrXII,known_gene
878281,879508,1227,1,1,chrXII,known_gene
883372,883735,363,1,1,chrXII,novel_orf
903931,904390,459,1,1,chrXII,known_gene
907078,907918,840,1,1,chrXII,known_gene
913627,914041,414,1,1,chrXII,novel_orf
925567,927619,2052,1,1,chrXII,known_gene
929788,930892,1104,1,1,chrXII,known_gene
935776,936184,408,1,1,chrXII,novel_orf
937540,940981,3441,1,1,chrXII,known_gene
941482,942799,1317,1,1,chrXII,novel_orf
948367,949192,825,1,1,chrXII,known_gene
955009,956710,1701,1,1,chrXII,known_gene
963784,964879,1095,1,1,chrXII,known_gene
965896,971695,5799,1,1,chrXII,known_gene
977902,978217,315,1,1,chrXII,novel_orf
993433,1000129,6696,1,1,chrXII,known_gene
1000360,1000768,408,1,1,chrXII,novel_orf
1002556,1004128,1572,1,1,chrXII,known_gene
1014490,1015450,960,1,1,chrXII,known_gene
1040830,1041160,330,1,1,chrXII,novel_orf
1053628,1054543,915,1,1,chrXII,known_gene
1056454,1056835,381,1,1,chrXII,known_gene
1057333,1058518,1185,1,1,chrXII,known_gene
1065955,1066564,609,1,1,chrXII,known_gene
1067086,1071235,4149,1,1,chrXII,known_gene
1072507,1077898,5391,1,1,chrXII,known_gene
842,1325,483,1,2,chrXII,known_gene
1625,2309,684,1,2,chrXII,novel_orf
6485,6968,483,1,2,chrXII,known_gene
7268,7844,576,1,2,chrXII,novel_orf
30506,30830,324,1,2,chrXII,known_gene
47834,48134,300,1,2,chrXII,novel_orf
48215,48662,447,1,2,chrXII,known_gene
49937,51947,2010,1,2,chrXII,known_gene
68579,70478,1899,1,2,chrXII,known_gene
84803,86564,1761,1,2,chrXII,known_gene
88622,91349,2727,1,2,chrXII,known_gene
100946,105347,4401,1,2,chrXII,known_gene
155768,156164,396,1,2,chrXII,novel_orf
171338,171764,426,1,2,chrXII,known_gene
175226,176744,1518,1,2,chrXII,known_gene
180287,181481,1194,1,2,chrXII,known_gene
204224,204785,561,1,2,chrXII,known_gene
208760,210269,1509,1,2,chrXII,known_gene
214082,214397,315,1,2,chrXII,novel_orf
229376,229697,321,1,2,chrXII,known_gene
255305,257855,2550,1,2,chrXII,known_gene
260978,262766,1788,1,2,chrXII,known_gene
271007,271463,456,1,2,chrXII,known_gene
277484,277799,315,1,2,chrXII,novel_orf
277841,278150,309,1,2,chrXII,novel_orf
278861,280943,2082,1,2,chrXII,known_gene
282926,283592,666,1,2,chrXII,known_gene
283871,285623,1752,1,2,chrXII,known_gene
287915,289250,1335,1,2,chrXII,known_gene
292514,292907,393,1,2,chrXII,novel_orf
316106,317951,1845,1,2,chrXII,known_gene
323543,326225,2682,1,2,chrXII,known_gene
364115,365330,1215,1,2,chrXII,known_gene
368780,369311,531,1,2,chrXII,known_gene
370790,371210,420,1,2,chrXII,known_gene
377984,380564,2580,1,2,chrXII,known_gene
399656,402488,2832,1,2,chrXII,known_gene
405455,405761,306,1,2,chrXII,novel_orf
417005,418109,1104,1,2,chrXII,known_gene
418436,421394,2958,1,2,chrXII,known_gene
423473,423800,327,1,2,chrXII,known_gene
427328,429386,2058,1,2,chrXII,known_gene
432167,432773,606,1,2,chrXII,known_gene
446819,447161,342,1,2,chrXII,novel_orf
463832,464207,375,1,2,chrXII,novel_orf
472112,472457,345,1,2,chrXII,known_gene
488996,489341,345,1,2,chrXII,known_gene
489572,489929,357,1,2,chrXII,known_gene
500732,501122,390,1,2,chrXII,known_gene
504590,505829,1239,1,2,chrXII,known_gene
515261,516410,1149,1,2,chrXII,known_gene
523631,524390,759,1,2,chrXII,known_gene
524864,527945,3081,1,2,chrXII,known_gene
528299,530387,2088,1,2,chrXII,known_gene
547979,548312,333,1,2,chrXII,novel_orf
549011,549356,345,1,2,chrXII,known_gene
552269,552605,336,1,2,chrXII,known_gene
556787,559289,2502,1,2,chrXII,known_gene
559550,560444,894,1,2,chrXII,known_gene
562007,563390,1383,1,2,chrXII,known_gene
576824,577793,969,1,2,chrXII,known_gene
586463,587573,1110,1,2,chrXII,known_gene
595238,598706,3468,1,2,chrXII,novel_orf
609782,611753,1971,1,2,chrXII,known_gene
636779,639914,3135,1,2,chrXII,known_gene
640316,641021,705,1,2,chrXII,known_gene
642626,644336,1710,1,2,chrXII,known_gene
651116,652439,1323,1,2,chrXII,novel_orf
654176,656387,2211,1,2,chrXII,novel_orf
665843,667907,2064,1,2,chrXII,known_gene
681185,682238,1053,1,2,chrXII,known_gene
682736,683561,825,1,2,chrXII,known_gene
705185,706130,945,1,2,chrXII,known_gene
714299,714686,387,1,2,chrXII,novel_orf
715088,717026,1938,1,2,chrXII,known_gene
724043,724433,390,1,2,chrXII,known_gene
724856,725213,357,1,2,chrXII,novel_orf
726068,728051,1983,1,2,chrXII,known_gene
728954,730301,1347,1,2,chrXII,known_gene
736511,736955,444,1,2,chrXII,novel_orf
740873,741173,300,1,2,chrXII,novel_orf
745619,746525,906,1,2,chrXII,known_gene
759479,760241,762,1,2,chrXII,known_gene
764807,765269,462,1,2,chrXII,known_gene
766541,769196,2655,1,2,chrXII,known_gene
797429,799592,2163,1,2,chrXII,known_gene
805886,806825,939,1,2,chrXII,known_gene
809996,815627,5631,1,2,chrXII,known_gene
840320,840914,594,1,2,chrXII,known_gene
867353,868391,1038,1,2,chrXII,known_gene
879722,881924,2202,1,2,chrXII,known_gene
885287,888632,3345,1,2,chrXII,known_gene
893627,896270,2643,1,2,chrXII,known_gene
903065,903404,339,1,2,chrXII,known_gene
907949,909398,1449,1,2,chrXII,known_gene
928742,929600,858,1,2,chrXII,known_gene
932966,933653,687,1,2,chrXII,known_gene
942755,946796,4041,1,2,chrXII,novel_orf
947252,947978,726,1,2,chrXII,known_gene
951155,953183,2028,1,2,chrXII,known_gene
958427,962735,4308,1,2,chrXII,known_gene
973394,975521,2127,1,2,chrXII,known_gene
988427,990440,2013,1,2,chrXII,known_gene
990776,992732,1956,1,2,chrXII,known_gene
1000079,1000379,300,1,2,chrXII,known_gene
1022624,1023971,1347,1,2,chrXII,known_gene
1025213,1026515,1302,1,2,chrXII,known_gene
1032626,1035764,3138,1,2,chrXII,known_gene
1055069,1055684,615,1,2,chrXII,known_gene
1066571,1067222,651,1,2,chrXII,known_gene
1069571,1070147,576,1,2,chrXII,known_gene
1076234,1076810,576,1,2,chrXII,known_gene
1077049,1077532,483,-1,0,chrXII,known_gene
1076173,1076749,576,-1,0,chrXII,novel_orf
1073665,1074016,351,-1,0,chrXII,novel_orf
1070386,1070869,483,-1,0,chrXII,known_gene
1069510,1070086,576,-1,0,chrXII,novel_orf
1067044,1067353,309,-1,0,chrXII,known_gene
1066264,1066816,552,-1,0,chrXII,known_gene
1035142,1035466,324,-1,0,chrXII,novel_orf
1023685,1023988,303,-1,0,chrXII,known_gene
1019314,1022251,2937,-1,0,chrXII,known_gene
1015567,1017697,2130,-1,0,chrXII,known_gene
1006024,1006408,384,-1,0,chrXII,known_gene
990616,990961,345,-1,0,chrXII,known_gene
980092,981409,1317,-1,0,chrXII,novel_orf
965089,965560,471,-1,0,chrXII,known_gene
954490,954889,399,-1,0,chrXII,known_gene
952108,952531,423,-1,0,chrXII,novel_orf
951268,951847,579,-1,0,chrXII,novel_orf
944674,944989,315,-1,0,chrXII,novel_orf
922441,924448,2007,-1,0,chrXII,known_gene
910234,912310,2076,-1,0,chrXII,known_gene
908569,908929,360,-1,0,chrXII,novel_orf
888850,892900,4050,-1,0,chrXII,known_gene
888175,888481,306,-1,0,chrXII,novel_orf
873745,874792,1047,-1,0,chrXII,known_gene
847387,849124,1737,-1,0,chrXII,known_gene
822286,822592,306,-1,0,chrXII,known_gene
816295,816652,357,-1,0,chrXII,novel_orf
805783,806335,552,-1,0,chrXII,known_gene
804091,804415,324,-1,0,chrXII,known_gene
802849,803233,384,-1,0,chrXII,known_gene
799696,802396,2700,-1,0,chrXII,known_gene
799111,799471,360,-1,0,chrXII,novel_orf
788623,789331,708,-1,0,chrXII,novel_orf
765265,765757,492,-1,0,chrXII,known_gene
762574,764137,1563,-1,0,chrXII,known_gene
757636,758833,1197,-1,0,chrXII,known_gene
757264,757612,348,-1,0,chrXII,known_gene
738160,743863,5703,-1,0,chrXII,known_gene
735211,737548,2337,-1,0,chrXII,known_gene
732868,733333,465,-1,0,chrXII,novel_orf
732190,732553,363,-1,0,chrXII,known_gene
724720,725416,696,-1,0,chrXII,known_gene
719788,720370,582,-1,0,chrXII,known_gene
713479,714904,1425,-1,0,chrXII,known_gene
705070,705412,342,-1,0,chrXII,known_gene
704482,704833,351,-1,0,chrXII,known_gene
683671,687202,3531,-1,0,chrXII,known_gene
668236,668563,327,-1,0,chrXII,known_gene
663283,665002,1719,-1,0,chrXII,known_gene
647245,647557,312,-1,0,chrXII,novel_orf
582232,585490,3258,-1,0,chrXII,known_gene
572095,573211,1116,-1,0,chrXII,known_gene
570775,571858,1083,-1,0,chrXII,known_gene
566653,567922,1269,-1,0,chrXII,known_gene
564859,566281,1422,-1,0,chrXII,known_gene
563791,564214,423,-1,0,chrXII,known_gene
547852,548515,663,-1,0,chrXII,known_gene
547285,547645,360,-1,0,chrXII,known_gene
541936,543304,1368,-1,0,chrXII,known_gene
540808,541573,765,-1,0,chrXII,known_gene
528349,528826,477,-1,0,chrXII,novel_orf
507796,510232,2436,-1,0,chrXII,known_gene
501259,502162,903,-1,0,chrXII,known_gene
500578,501049,471,-1,0,chrXII,known_gene
482548,483637,1089,-1,0,chrXII,known_gene
476332,479800,3468,-1,0,chrXII,novel_orf
442957,444688,1731,-1,0,chrXII,known_gene
429676,432016,2340,-1,0,chrXII,known_gene
419383,419719,336,-1,0,chrXII,novel_orf
418546,418858,312,-1,0,chrXII,novel_orf
411259,411841,582,-1,0,chrXII,novel_orf
410749,411067,318,-1,0,chrXII,novel_orf
404509,406822,2313,-1,0,chrXII,known_gene
402793,404062,1269,-1,0,chrXII,known_gene
400747,401299,552,-1,0,chrXII,novel_orf
384724,385408,684,-1,0,chrXII,known_gene
342565,342961,396,-1,0,chrXII,known_gene
326512,327268,756,-1,0,chrXII,known_gene
292393,293572,1179,-1,0,chrXII,known_gene
288124,288526,402,-1,0,chrXII,novel_orf
280237,280894,657,-1,0,chrXII,novel_orf
279451,279787,336,-1,0,chrXII,novel_orf
275377,278626,3249,-1,0,chrXII,known_gene
248716,250255,1539,-1,0,chrXII,known_gene
238000,238813,813,-1,0,chrXII,known_gene
235036,237703,2667,-1,0,chrXII,known_gene
228907,229582,675,-1,0,chrXII,known_gene
219385,220708,1323,-1,0,chrXII,novel_orf
212368,214456,2088,-1,0,chrXII,known_gene
210511,211933,1422,-1,0,chrXII,known_gene
196828,198127,1299,-1,0,chrXII,known_gene
185497,187129,1632,-1,0,chrXII,known_gene
175570,175957,387,-1,0,chrXII,novel_orf
172267,174982,2715,-1,0,chrXII,known_gene
169981,170350,369,-1,0,chrXII,known_gene
157933,159505,1572,-1,0,chrXII,known_gene
154342,156334,1992,-1,0,chrXII,known_gene
122074,124714,2640,-1,0,chrXII,known_gene
105685,107899,2214,-1,0,chrXII,known_gene
102415,102889,474,-1,0,chrXII,novel_orf
99043,100201,1158,-1,0,chrXII,known_gene
97996,98836,840,-1,0,chrXII,known_gene
74269,76747,2478,-1,0,chrXII,known_gene
35911,36361,450,-1,0,chrXII,known_gene
14647,16072,1425,-1,0,chrXII,known_gene
7207,7783,576,-1,0,chrXII,known_gene
1564,2248,684,-1,0,chrXII,known_gene
1076256,1076763,507,-1,1,chrXII,novel_orf
1075551,1075887,336,-1,1,chrXII,novel_orf
1069593,1070100,507,-1,1,chrXII,novel_orf
1068888,1069224,336,-1,1,chrXII,novel_orf
1059756,1060887,1131,-1,1,chrXII,known_gene
1055811,1056771,960,-1,1,chrXII,known_gene
1041798,1042986,1188,-1,1,chrXII,known_gene
1039269,1041366,2097,-1,1,chrXII,known_gene
1026855,1027893,1038,-1,1,chrXII,known_gene
1018140,1018908,768,-1,1,chrXII,known_gene
1014615,1014936,321,-1,1,chrXII,novel_orf
1011621,1012023,402,-1,1,chrXII,known_gene
1004346,1006008,1662,-1,1,chrXII,known_gene
1000341,1001703,1362,-1,1,chrXII,known_gene
999090,999462,372,-1,1,chrXII,novel_orf
976611,980136,3525,-1,1,chrXII,novel_orf
971916,973170,1254,-1,1,chrXII,known_gene
970896,971394,498,-1,1,chrXII,novel_orf
956913,958095,1182,-1,1,chrXII,known_gene
954258,954597,339,-1,1,chrXII,known_gene
953352,954144,792,-1,1,chrXII,known_gene
934413,937233,2820,-1,1,chrXII,known_gene
912549,914892,2343,-1,1,chrXII,known_gene
896373,897672,1299,-1,1,chrXII,known_gene
882066,884751,2685,-1,1,chrXII,known_gene
871452,871842,390,-1,1,chrXII,known_gene
861717,862254,537,-1,1,chrXII,known_gene
858489,858843,354,-1,1,chrXII,novel_orf
843486,844050,564,-1,1,chrXII,known_gene
838065,839253,1188,-1,1,chrXII,known_gene
836349,837357,1008,-1,1,chrXII,known_gene
829488,830364,876,-1,1,chrXII,known_gene
823827,826413,2586,-1,1,chrXII,known_gene
791409,791748,339,-1,1,chrXII,novel_orf
790668,791046,378,-1,1,chrXII,known_gene
788475,789315,840,-1,1,chrXII,novel_orf
776583,777864,1281,-1,1,chrXII,known_gene
769317,771684,2367,-1,1,chrXII,known_gene
760749,762342,1593,-1,1,chrXII,known_gene
752223,756993,4770,-1,1,chrXII,known_gene
721998,722373,375,-1,1,chrXII,known_gene
717144,717978,834,-1,1,chrXII,known_gene
708447,710136,1689,-1,1,chrXII,known_gene
706197,707040,843,-1,1,chrXII,known_gene
697155,699495,2340,-1,1,chrXII,known_gene
689082,691029,1947,-1,1,chrXII,known_gene
680865,681216,351,-1,1,chrXII,known_gene
675618,677724,2106,-1,1,chrXII,known_gene
644403,644973,570,-1,1,chrXII,known_gene
628683,633354,4671,-1,1,chrXII,known_gene
625167,626331,1164,-1,1,chrXII,known_gene
622917,623883,966,-1,1,chrXII,known_gene
611793,612117,324,-1,1,chrXII,known_gene
610359,610665,306,-1,1,chrXII,novel_orf
605757,607119,1362,-1,1,chrXII,known_gene
600018,602463,2445,-1,1,chrXII,known_gene
587694,588918,1224,-1,1,chrXII,known_gene
578361,579024,663,-1,1,chrXII,known_gene
573465,573918,453,-1,1,chrXII,known_gene
560796,561732,936,-1,1,chrXII,known_gene
552723,553677,954,-1,1,chrXII,known_gene
549510,550293,783,-1,1,chrXII,known_gene
545067,545448,381,-1,1,chrXII,novel_orf
538791,539589,798,-1,1,chrXII,known_gene
530796,534393,3597,-1,1,chrXII,known_gene
520542,522012,1470,-1,1,chrXII,known_gene
518274,518583,309,-1,1,chrXII,novel_orf
514107,514713,606,-1,1,chrXII,known_gene
494493,495258,765,-1,1,chrXII,known_gene
491865,493254,1389,-1,1,chrXII,known_gene
472968,474057,1089,-1,1,chrXII,known_gene
447981,448314,333,-1,1,chrXII,known_gene
441714,442737,1023,-1,1,chrXII,known_gene
434157,434463,306,-1,1,chrXII,known_gene
432822,433725,903,-1,1,chrXII,known_gene
420852,421182,330,-1,1,chrXII,novel_orf
419793,420132,339,-1,1,chrXII,novel_orf
415800,416658,858,-1,1,chrXII,known_gene
395757,398319,2562,-1,1,chrXII,known_gene
394764,395520,756,-1,1,chrXII,known_gene
391077,391407,330,-1,1,chrXII,known_gene
388743,390270,1527,-1,1,chrXII,known_gene
382470,384534,2064,-1,1,chrXII,known_gene
374943,377238,2295,-1,1,chrXII,known_gene
369696,370098,402,-1,1,chrXII,known_gene
366666,368124,1458,-1,1,chrXII,known_gene
349005,363738,14733,-1,1,chrXII,known_gene
347046,348180,1134,-1,1,chrXII,known_gene
342969,343767,798,-1,1,chrXII,known_gene
329676,332115,2439,-1,1,chrXII,known_gene
327729,329238,1509,-1,1,chrXII,known_gene
322854,323154,300,-1,1,chrXII,novel_orf
304776,305142,366,-1,1,chrXII,novel_orf
300672,301989,1317,-1,1,chrXII,known_gene
294090,296094,2004,-1,1,chrXII,known_gene
285735,286131,396,-1,1,chrXII,known_gene
281955,282456,501,-1,1,chrXII,known_gene
274140,275211,1071,-1,1,chrXII,known_gene
271629,273915,2286,-1,1,chrXII,known_gene
259737,260547,810,-1,1,chrXII,known_gene
257991,259401,1410,-1,1,chrXII,known_gene
251271,253080,1809,-1,1,chrXII,known_gene
245586,246072,486,-1,1,chrXII,known_gene
243885,245172,1287,-1,1,chrXII,known_gene
239346,241407,2061,-1,1,chrXII,known_gene
232389,234081,1692,-1,1,chrXII,known_gene
229965,230451,486,-1,1,chrXII,known_gene
222684,223059,375,-1,1,chrXII,known_gene
221520,222132,612,-1,1,chrXII,known_gene
215439,218907,3468,-1,1,chrXII,novel_orf
201975,202590,615,-1,1,chrXII,known_gene
199539,201315,1776,-1,1,chrXII,known_gene
187662,193281,5619,-1,1,chrXII,known_gene
184173,184926,753,-1,1,chrXII,known_gene
181788,183405,1617,-1,1,chrXII,known_gene
167319,167802,483,-1,1,chrXII,known_gene
165576,166083,507,-1,1,chrXII,known_gene
161754,163893,2139,-1,1,chrXII,known_gene
160125,160509,384,-1,1,chrXII,novel_orf
134301,136299,1998,-1,1,chrXII,known_gene
132498,132822,324,-1,1,chrXII,novel_orf
119331,119718,387,-1,1,chrXII,novel_orf
105555,105861,306,-1,1,chrXII,known_gene
95565,97485,1920,-1,1,chrXII,known_gene
87531,87870,339,-1,1,chrXII,novel_orf
80355,80697,342,-1,1,chrXII,known_gene
77151,80205,3054,-1,1,chrXII,known_gene
70632,73146,2514,-1,1,chrXII,known_gene
66744,68256,1512,-1,1,chrXII,known_gene
54210,63645,9435,-1,1,chrXII,known_gene
53130,53931,801,-1,1,chrXII,known_gene
52086,52590,504,-1,1,chrXII,known_gene
46713,47463,750,-1,1,chrXII,known_gene
37332,39471,2139,-1,1,chrXII,known_gene
35502,35961,459,-1,1,chrXII,known_gene
27408,28305,897,-1,1,chrXII,known_gene
25755,26994,1239,-1,1,chrXII,known_gene
22473,22980,507,-1,1,chrXII,known_gene
16638,17613,975,-1,1,chrXII,known_gene
1047311,1047644,333,-1,2,chrXII,novel_orf
1031375,1031918,543,-1,2,chrXII,novel_orf
1007420,1011245,3825,-1,2,chrXII,known_gene
990893,991223,330,-1,2,chrXII,known_gene
933884,934253,369,-1,2,chrXII,known_gene
919535,921596,2061,-1,2,chrXII,known_gene
915155,919019,3864,-1,2,chrXII,known_gene
904748,906305,1557,-1,2,chrXII,known_gene
899576,902660,3084,-1,2,chrXII,known_gene
892991,893390,399,-1,2,chrXII,known_gene
875735,877178,1443,-1,2,chrXII,known_gene
872825,873554,729,-1,2,chrXII,known_gene
868661,871367,2706,-1,2,chrXII,known_gene
860981,861419,438,-1,2,chrXII,novel_orf
852494,853151,657,-1,2,chrXII,known_gene
826976,827873,897,-1,2,chrXII,known_gene
810107,810560,453,-1,2,chrXII,novel_orf
802652,805106,2454,-1,2,chrXII,known_gene
796697,797078,381,-1,2,chrXII,known_gene
795572,795899,327,-1,2,chrXII,known_gene
780347,780758,411,-1,2,chrXII,novel_orf
778172,778952,780,-1,2,chrXII,known_gene
749033,751769,2736,-1,2,chrXII,known_gene
721700,722030,330,-1,2,chrXII,known_gene
720770,721430,660,-1,2,chrXII,known_gene
718316,719462,1146,-1,2,chrXII,known_gene
710990,712058,1068,-1,2,chrXII,known_gene
704492,704960,468,-1,2,chrXII,known_gene
699998,704024,4026,-1,2,chrXII,known_gene
695045,696830,1785,-1,2,chrXII,known_gene
674426,675455,1029,-1,2,chrXII,known_gene
668243,668891,648,-1,2,chrXII,known_gene
645599,645953,354,-1,2,chrXII,known_gene
643382,643718,336,-1,2,chrXII,novel_orf
636830,637175,345,-1,2,chrXII,novel_orf
626501,626930,429,-1,2,chrXII,known_gene
618527,618962,435,-1,2,chrXII,novel_orf
616331,617318,987,-1,2,chrXII,known_gene
611531,611930,399,-1,2,chrXII,known_gene
607424,609524,2100,-1,2,chrXII,known_gene
604211,604787,576,-1,2,chrXII,known_gene
590561,592043,1482,-1,2,chrXII,known_gene
579317,581771,2454,-1,2,chrXII,known_gene
550649,551960,1311,-1,2,chrXII,known_gene
540008,540536,528,-1,2,chrXII,known_gene
516677,517670,993,-1,2,chrXII,known_gene
515357,515696,339,-1,2,chrXII,novel_orf
513161,513821,660,-1,2,chrXII,known_gene
499577,500270,693,-1,2,chrXII,known_gene
495428,498044,2616,-1,2,chrXII,known_gene
486200,487289,1089,-1,2,chrXII,known_gene
480278,481601,1323,-1,2,chrXII,novel_orf
469316,470405,1089,-1,2,chrXII,known_gene
445523,447575,2052,-1,2,chrXII,known_gene
437630,439823,2193,-1,2,chrXII,known_gene
424361,424736,375,-1,2,chrXII,novel_orf
421541,423473,1932,-1,2,chrXII,known_gene
407282,408155,873,-1,2,chrXII,known_gene
390953,391331,378,-1,2,chrXII,known_gene
386510,388220,1710,-1,2,chrXII,known_gene
374975,375476,501,-1,2,chrXII,known_gene
343988,345941,1953,-1,2,chrXII,known_gene
339743,340928,1185,-1,2,chrXII,known_gene
337526,339473,1947,-1,2,chrXII,known_gene
336230,337265,1035,-1,2,chrXII,known_gene
321218,321770,552,-1,2,chrXII,novel_orf
318236,320015,1779,-1,2,chrXII,known_gene
306854,315731,8877,-1,2,chrXII,known_gene
296588,300251,3663,-1,2,chrXII,known_gene
283184,283607,423,-1,2,chrXII,known_gene
281018,281621,603,-1,2,chrXII,known_gene
267812,270710,2898,-1,2,chrXII,known_gene
266372,266918,546,-1,2,chrXII,known_gene
263576,263954,378,-1,2,chrXII,known_gene
248099,248426,327,-1,2,chrXII,known_gene
247571,247946,375,-1,2,chrXII,novel_orf
246323,246977,654,-1,2,chrXII,known_gene
231701,232013,312,-1,2,chrXII,known_gene
225425,228596,3171,-1,2,chrXII,known_gene
217244,217637,393,-1,2,chrXII,novel_orf
205730,206108,378,-1,2,chrXII,novel_orf
195449,196472,1023,-1,2,chrXII,known_gene
178706,179606,900,-1,2,chrXII,known_gene
176801,177416,615,-1,2,chrXII,known_gene
156854,157730,876,-1,2,chrXII,known_gene
151388,153977,2589,-1,2,chrXII,known_gene
141521,141839,318,-1,2,chrXII,novel_orf
137939,140546,2607,-1,2,chrXII,known_gene
129329,130613,1284,-1,2,chrXII,known_gene
109901,111575,1674,-1,2,chrXII,known_gene
65774,66518,744,-1,2,chrXII,known_gene
64061,65207,1146,-1,2,chrXII,known_gene
50060,50438,378,-1,2,chrXII,novel_orf
47858,48629,771,-1,2,chrXII,known_gene
41279,46265,4986,-1,2,chrXII,known_gene
39803,40274,471,-1,2,chrXII,known_gene
32672,35204,2532,-1,2,chrXII,known_gene
31025,31397,372,-1,2,chrXII,novel_orf
24245,24656,411,-1,2,chrXII,novel_orf
21137,21839,702,-1,2,chrXII,known_gene
13082,13445,363,-1,2,chrXII,known_gene
9527,10343,816,-1,2,chrXII,known_gene
6119,9113,2994,-1,2,chrXII,known_gene
3992,4808,816,-1,2,chrXII,known_gene
584,3578,2994,-1,2,chrXII,known_gene
10197,11295,1098,1,0,chrXIII,known_gene
19791,20172,381,1,0,chrXIII,novel_orf
28665,29004,339,1,0,chrXIII,novel_orf
34242,37647,3405,1,0,chrXIII,known_gene
46941,49704,2763,1,0,chrXIII,known_gene
50376,50688,312,1,0,chrXIII,novel_orf
51639,54468,2829,1,0,chrXIII,known_gene
54792,55110,318,1,0,chrXIII,known_gene
56772,57453,681,1,0,chrXIII,known_gene
70623,73920,3297,1,0,chrXIII,known_gene
79908,81486,1578,1,0,chrXIII,known_gene
111864,112344,480,1,0,chrXIII,known_gene
115986,116370,384,1,0,chrXIII,novel_orf
140547,140862,315,1,0,chrXIII,novel_orf
142209,144954,2745,1,0,chrXIII,known_gene
146481,147249,768,1,0,chrXIII,known_gene
160179,161994,1815,1,0,chrXIII,known_gene
178425,179637,1212,1,0,chrXIII,known_gene
179892,180258,366,1,0,chrXIII,known_gene
181473,183363,1890,1,0,chrXIII,known_gene
186261,189729,3468,1,0,chrXIII,novel_orf
205641,206211,570,1,0,chrXIII,known_gene
214188,216156,1968,1,0,chrXIII,known_gene
220137,220728,591,1,0,chrXIII,known_gene
228936,229500,564,1,0,chrXIII,known_gene
234912,235236,324,1,0,chrXIII,novel_orf
236994,238731,1737,1,0,chrXIII,known_gene
248013,248388,375,1,0,chrXIII,known_gene
250434,250911,477,1,0,chrXIII,known_gene
260220,261609,1389,1,0,chrXIII,known_gene
264540,266754,2214,1,0,chrXIII,known_gene
273117,273714,597,1,0,chrXIII,known_gene
281598,281967,369,1,0,chrXIII,novel_orf
285099,286317,1218,1,0,chrXIII,known_gene
288078,289704,1626,1,0,chrXIII,known_gene
307488,308682,1194,1,0,chrXIII,known_gene
319755,320055,300,1,0,chrXIII,novel_orf
330792,331923,1131,1,0,chrXIII,known_gene
352602,353136,534,1,0,chrXIII,known_gene
355383,356811,1428,1,0,chrXIII,known_gene
388821,390732,1911,1,0,chrXIII,known_gene
391038,391485,447,1,0,chrXIII,known_gene
392754,394788,2034,1,0,chrXIII,known_gene
397902,399459,1557,1,0,chrXIII,known_gene
434787,435915,1128,1,0,chrXIII,known_gene
437490,438789,1299,1,0,chrXIII,known_gene
442638,442977,339,1,0,chrXIII,known_gene
449244,449928,684,1,0,chrXIII,known_gene
454014,455556,1542,1,0,chrXIII,known_gene
466299,468162,1863,1,0,chrXIII,known_gene
484083,486147,2064,1,0,chrXIII,known_gene
497703,499209,1506,1,0,chrXIII,known_gene
499551,499869,318,1,0,chrXIII,novel_orf
505332,507207,1875,1,0,chrXIII,known_gene
509874,510198,324,1,0,chrXIII,novel_orf
514455,517287,2832,1,0,chrXIII,known_gene
517869,520446,2577,1,0,chrXIII,known_gene
523695,527499,3804,1,0,chrXIII,known_gene
537837,538551,714,1,0,chrXIII,known_gene
539910,540444,534,1,0,chrXIII,known_gene
545154,545730,576,1,0,chrXIII,known_gene
547713,549183,1470,1,0,chrXIII,known_gene
572247,572715,468,1,0,chrXIII,known_gene
574470,574791,321,1,0,chrXIII,known_gene
590427,590751,324,1,0,chrXIII,novel_orf
594885,597195,2310,1,0,chrXIII,known_gene
608688,609981,1293,1,0,chrXIII,known_gene
611739,615975,4236,1,0,chrXIII,known_gene
619857,622134,2277,1,0,chrXIII,known_gene
628188,628785,597,1,0,chrXIII,known_gene
654033,654417,384,1,0,chrXIII,known_gene
662643,664284,1641,1,0,chrXIII,known_gene
667536,668205,669,1,0,chrXIII,known_gene
678714,679053,339,1,0,chrXIII,novel_orf
680646,681000,354,1,0,chrXIII,novel_orf
681936,682317,381,1,0,chrXIII,novel_orf
683001,683406,405,1,0,chrXIII,novel_orf
689082,690510,1428,1,0,chrXIII,known_gene
695268,696483,1215,1,0,chrXIII,known_gene
696795,698370,1575,1,0,chrXIII,known_gene
718965,719316,351,1,0,chrXIII,novel_orf
724014,724338,324,1,0,chrXIII,novel_orf
727905,728253,348,1,0,chrXIII,novel_orf
740265,741312,1047,1,0,chrXIII,known_gene
743748,745923,2175,1,0,chrXIII,known_gene
746352,747729,1377,1,0,chrXIII,known_gene
758562,759183,621,1,0,chrXIII,known_gene
772914,774015,1101,1,0,chrXIII,known_gene
789381,789732,351,1,0,chrXIII,novel_orf
793725,794667,942,1,0,chrXIII,known_gene
795804,796416,612,1,0,chrXIII,known_gene
801771,802704,933,1,0,chrXIII,known_gene
813081,813513,432,1,0,chrXIII,novel_orf
816552,816867,315,1,0,chrXIII,novel_orf
818826,819948,1122,1,0,chrXIII,known_gene
822762,824631,1869,1,0,chrXIII,known_gene
828642,829104,462,1,0,chrXIII,novel_orf
832338,833253,915,1,0,chrXIII,known_gene
851421,851769,348,1,0,chrXIII,known_gene
856965,858087,1122,1,0,chrXIII,known_gene
859407,859722,315,1,0,chrXIII,novel_orf
859830,860130,300,1,0,chrXIII,novel_orf
861921,863520,1599,1,0,chrXIII,known_gene
867609,868173,564,1,0,chrXIII,novel_orf
874986,878679,3693,1,0,chrXIII,known_gene
898404,899226,822,1,0,chrXIII,known_gene
902799,903849,1050,1,0,chrXIII,known_gene
904824,905835,1011,1,0,chrXIII,known_gene
826,1309,483,1,1,chrXIII,known_gene
1609,2185,576,1,1,chrXIII,known_gene
7243,8383,1140,1,1,chrXIII,known_gene
26929,27862,933,1,1,chrXIII,known_gene
30610,31684,1074,1,1,chrXIII,known_gene
37471,37774,303,1,1,chrXIII,known_gene
39226,39547,321,1,1,chrXIII,known_gene
42277,42613,336,1,1,chrXIII,novel_orf
44044,44791,747,1,1,chrXIII,known_gene
68293,69700,1407,1,1,chrXIII,known_gene
77266,77770,504,1,1,chrXIII,known_gene
82471,82849,378,1,1,chrXIII,known_gene
83089,85789,2700,1,1,chrXIII,known_gene
104776,108532,3756,1,1,chrXIII,known_gene
108805,110077,1272,1,1,chrXIII,known_gene
111001,111550,549,1,1,chrXIII,known_gene
133474,135229,1755,1,1,chrXIII,known_gene
135499,137158,1659,1,1,chrXIII,known_gene
151870,153001,1131,1,1,chrXIII,known_gene
159382,159697,315,1,1,chrXIII,known_gene
170401,171310,909,1,1,chrXIII,known_gene
192787,194800,2013,1,1,chrXIII,known_gene
196627,197950,1323,1,1,chrXIII,novel_orf
209524,211495,1971,1,1,chrXIII,known_gene
211714,212155,441,1,1,chrXIII,known_gene
231148,233143,1995,1,1,chrXIII,known_gene
246115,246751,636,1,1,chrXIII,known_gene
263482,264355,873,1,1,chrXIII,known_gene
284101,284641,540,1,1,chrXIII,known_gene
291133,294967,3834,1,1,chrXIII,known_gene
298867,300427,1560,1,1,chrXIII,known_gene
310207,311752,1545,1,1,chrXIII,known_gene
315376,316903,1527,1,1,chrXIII,known_gene
318679,319177,498,1,1,chrXIII,known_gene
321874,323047,1173,1,1,chrXIII,known_gene
323299,324187,888,1,1,chrXIII,known_gene
325876,327289,1413,1,1,chrXIII,known_gene
327481,328582,1101,1,1,chrXIII,known_gene
334708,335035,327,1,1,chrXIII,known_gene
338329,339277,948,1,1,chrXIII,known_gene
350380,350863,483,1,1,chrXIII,known_gene
379585,380200,615,1,1,chrXIII,known_gene
383302,385975,2673,1,1,chrXIII,known_gene
406303,407584,1281,1,1,chrXIII,known_gene
409153,410626,1473,1,1,chrXIII,known_gene
411568,412120,552,1,1,chrXIII,known_gene
436627,437416,789,1,1,chrXIII,known_gene
439207,442090,2883,1,1,chrXIII,known_gene
455824,457261,1437,1,1,chrXIII,known_gene
458407,459301,894,1,1,chrXIII,known_gene
483013,483361,348,1,1,chrXIII,known_gene
484450,484858,408,1,1,chrXIII,known_gene
486586,490246,3660,1,1,chrXIII,known_gene
494998,496282,1284,1,1,chrXIII,known_gene
506995,507370,375,1,1,chrXIII,known_gene
513592,513961,369,1,1,chrXIII,known_gene
527803,531817,4014,1,1,chrXIII,known_gene
536206,537514,1308,1,1,chrXIII,known_gene
541198,542881,1683,1,1,chrXIII,known_gene
546124,547237,1113,1,1,chrXIII,known_gene
559198,559870,672,1,1,chrXIII,known_gene
560365,560812,447,1,1,chrXIII,known_gene
560995,561856,861,1,1,chrXIII,known_gene
563095,564193,1098,1,1,chrXIII,known_gene
575065,577516,2451,1,1,chrXIII,known_gene
577717,578392,675,1,1,chrXIII,known_gene
605980,608140,2160,1,1,chrXIII,known_gene
608896,610081,1185,1,1,chrXIII,known_gene
618478,619303,825,1,1,chrXIII,known_gene
645400,646777,1377,1,1,chrXIII,known_gene
650035,650812,777,1,1,chrXIII,known_gene
655075,658342,3267,1,1,chrXIII,known_gene
668491,669655,1164,1,1,chrXIII,known_gene
675895,676837,942,1,1,chrXIII,known_gene
684466,685798,1332,1,1,chrXIII,known_gene
712315,713671,1356,1,1,chrXIII,known_gene
751960,752905,945,1,1,chrXIII,known_gene
757249,758317,1068,1,1,chrXIII,known_gene
770800,772558,1758,1,1,chrXIII,known_gene
778000,778567,567,1,1,chrXIII,known_gene
798517,801379,2862,1,1,chrXIII,known_gene
820255,822454,2199,1,1,chrXIII,known_gene
838186,839995,1809,1,1,chrXIII,known_gene
858208,858568,360,1,1,chrXIII,known_gene
863818,864271,453,1,1,chrXIII,known_gene
881158,886516,5358,1,1,chrXIII,known_gene
887002,888682,1680,1,1,chrXIII,known_gene
901708,902413,705,1,1,chrXIII,known_gene
907363,910786,3423,1,1,chrXIII,known_gene
1595,2102,507,1,2,chrXIII,known_gene
2471,2807,336,1,2,chrXIII,novel_orf
17063,18809,1746,1,2,chrXIII,known_gene
32333,33851,1518,1,2,chrXIII,known_gene
38195,39824,1629,1,2,chrXIII,known_gene
45062,45953,891,1,2,chrXIII,known_gene
55991,56309,318,1,2,chrXIII,novel_orf
63044,63404,360,1,2,chrXIII,novel_orf
74228,74558,330,1,2,chrXIII,known_gene
90743,91130,387,1,2,chrXIII,known_gene
92234,94241,2007,1,2,chrXIII,known_gene
99488,99797,309,1,2,chrXIII,known_gene
101861,103811,1950,1,2,chrXIII,known_gene
110246,110852,606,1,2,chrXIII,known_gene
120185,120761,576,1,2,chrXIII,novel_orf
120881,121277,396,1,2,chrXIII,novel_orf
127925,128432,507,1,2,chrXIII,novel_orf
129932,130397,465,1,2,chrXIII,novel_orf
137549,138944,1395,1,2,chrXIII,known_gene
164789,165326,537,1,2,chrXIII,known_gene
169415,169748,333,1,2,chrXIII,novel_orf
171593,172901,1308,1,2,chrXIII,known_gene
173138,174074,936,1,2,chrXIII,known_gene
184460,185783,1323,1,2,chrXIII,novel_orf
198428,201896,3468,1,2,chrXIII,novel_orf
216434,216914,480,1,2,chrXIII,known_gene
217361,219878,2517,1,2,chrXIII,known_gene
221405,222563,1158,1,2,chrXIII,known_gene
227042,227432,390,1,2,chrXIII,novel_orf
233456,234455,999,1,2,chrXIII,known_gene
243224,244064,840,1,2,chrXIII,known_gene
244148,245903,1755,1,2,chrXIII,known_gene
247676,250868,3192,1,2,chrXIII,known_gene
253847,255800,1953,1,2,chrXIII,known_gene
267173,267800,627,1,2,chrXIII,known_gene
272192,272663,471,1,2,chrXIII,known_gene
274016,275552,1536,1,2,chrXIII,known_gene
276044,277211,1167,1,2,chrXIII,known_gene
279959,280340,381,1,2,chrXIII,known_gene
312155,315005,2850,1,2,chrXIII,known_gene
324545,324875,330,1,2,chrXIII,novel_orf
335297,337307,2010,1,2,chrXIII,known_gene
341141,341675,534,1,2,chrXIII,known_gene
353870,354731,861,1,2,chrXIII,known_gene
365336,365648,312,1,2,chrXIII,novel_orf
366980,367934,954,1,2,chrXIII,known_gene
395600,396002,402,1,2,chrXIII,novel_orf
397076,397796,720,1,2,chrXIII,known_gene
399701,401216,1515,1,2,chrXIII,known_gene
401540,404237,2697,1,2,chrXIII,known_gene
407708,408566,858,1,2,chrXIII,known_gene
413981,416036,2055,1,2,chrXIII,known_gene
425366,426059,693,1,2,chrXIII,known_gene
442526,443381,855,1,2,chrXIII,known_gene
489398,489908,510,1,2,chrXIII,known_gene
492659,493172,513,1,2,chrXIII,novel_orf
532118,533027,909,1,2,chrXIII,known_gene
553361,554390,1029,1,2,chrXIII,known_gene
562505,562943,438,1,2,chrXIII,known_gene
564434,565862,1428,1,2,chrXIII,known_gene
568550,570194,1644,1,2,chrXIII,known_gene
571589,571973,384,1,2,chrXIII,novel_orf
579686,580010,324,1,2,chrXIII,novel_orf
581117,581429,312,1,2,chrXIII,novel_orf
616565,618098,1533,1,2,chrXIII,known_gene
629024,631970,2946,1,2,chrXIII,known_gene
632354,634472,2118,1,2,chrXIII,known_gene
637499,640604,3105,1,2,chrXIII,known_gene
647117,649280,2163,1,2,chrXIII,known_gene
659744,661529,1785,1,2,chrXIII,known_gene
664751,665522,771,1,2,chrXIII,known_gene
687515,688865,1350,1,2,chrXIII,known_gene
693380,695153,1773,1,2,chrXIII,known_gene
701789,703367,1578,1,2,chrXIII,known_gene
707132,712109,4977,1,2,chrXIII,known_gene
716714,718130,1416,1,2,chrXIII,known_gene
724625,725651,1026,1,2,chrXIII,known_gene
733544,736634,3090,1,2,chrXIII,known_gene
736925,738959,2034,1,2,chrXIII,known_gene
739184,739865,681,1,2,chrXIII,known_gene
742970,743444,474,1,2,chrXIII,known_gene
759806,761891,2085,1,2,chrXIII,known_gene
794918,795524,606,1,2,chrXIII,known_gene
804455,805091,636,1,2,chrXIII,known_gene
845570,848486,2916,1,2,chrXIII,known_gene
848684,849809,1125,1,2,chrXIII,known_gene
852629,854390,1761,1,2,chrXIII,known_gene
897164,897524,360,1,2,chrXIII,novel_orf
916745,917051,306,1,2,chrXIII,known_gene
920087,921401,1314,1,2,chrXIII,known_gene
922640,923015,375,1,2,chrXIII,known_gene
918365,919079,714,-1,0,chrXIII,known_gene
911060,912143,1083,-1,0,chrXIII,known_gene
899378,901307,1929,-1,0,chrXIII,known_gene
895715,896669,954,-1,0,chrXIII,known_gene
879062,880232,1170,-1,0,chrXIII,known_gene
873290,874337,1047,-1,0,chrXIII,known_gene
867554,869627,2073,-1,0,chrXIII,known_gene
859214,860891,1677,-1,0,chrXIII,known_gene
858296,858890,594,-1,0,chrXIII,known_gene
855398,856793,1395,-1,0,chrXIII,known_gene
850073,851591,1518,-1,0,chrXIII,known_gene
842435,845345,2910,-1,0,chrXIII,known_gene
840143,841691,1548,-1,0,chrXIII,known_gene
835325,836867,1542,-1,0,chrXIII,known_gene
827027,831329,4302,-1,0,chrXIII,known_gene
811232,813980,2748,-1,0,chrXIII,known_gene
806864,807548,684,-1,0,chrXIII,known_gene
805325,806423,1098,-1,0,chrXIII,known_gene
796004,796322,318,-1,0,chrXIII,novel_orf
789377,789839,462,-1,0,chrXIII,known_gene
777614,777923,309,-1,0,chrXIII,known_gene
760364,760754,390,-1,0,chrXIII,novel_orf
758516,758831,315,-1,0,chrXIII,known_gene
753224,753767,543,-1,0,chrXIII,known_gene
725933,731123,5190,-1,0,chrXIII,known_gene
722612,724385,1773,-1,0,chrXIII,known_gene
721592,722396,804,-1,0,chrXIII,known_gene
718574,720653,2079,-1,0,chrXIII,known_gene
715637,716309,672,-1,0,chrXIII,known_gene
713930,715445,1515,-1,0,chrXIII,known_gene
710627,710936,309,-1,0,chrXIII,novel_orf
702161,702545,384,-1,0,chrXIII,novel_orf
698810,701039,2229,-1,0,chrXIII,known_gene
685910,687284,1374,-1,0,chrXIII,known_gene
677192,683564,6372,-1,0,chrXIII,known_gene
658544,659198,654,-1,0,chrXIII,known_gene
651071,651458,387,-1,0,chrXIII,known_gene
636290,637004,714,-1,0,chrXIII,known_gene
634688,635984,1296,-1,0,chrXIII,known_gene
623615,624080,465,-1,0,chrXIII,known_gene
622250,623213,963,-1,0,chrXIII,known_gene
599351,600872,1521,-1,0,chrXIII,known_gene
593366,594473,1107,-1,0,chrXIII,known_gene
590039,592628,2589,-1,0,chrXIII,known_gene
587273,589550,2277,-1,0,chrXIII,known_gene
584270,586388,2118,-1,0,chrXIII,known_gene
574475,574928,453,-1,0,chrXIII,known_gene
570299,571016,717,-1,0,chrXIII,known_gene
557480,558524,1044,-1,0,chrXIII,known_gene
554792,556475,1683,-1,0,chrXIII,known_gene
550205,550895,690,-1,0,chrXIII,known_gene
542009,542345,336,-1,0,chrXIII,novel_orf
538688,540056,1368,-1,0,chrXIII,known_gene
533162,534698,1536,-1,0,chrXIII,known_gene
526736,527039,303,-1,0,chrXIII,novel_orf
525104,525422,318,-1,0,chrXIII,novel_orf
520760,521789,1029,-1,0,chrXIII,known_gene
515936,516530,594,-1,0,chrXIII,novel_orf
494099,494495,396,-1,0,chrXIII,known_gene
484526,484940,414,-1,0,chrXIII,novel_orf
472901,473264,363,-1,0,chrXIII,known_gene
469847,472352,2505,-1,0,chrXIII,known_gene
451631,453479,1848,-1,0,chrXIII,known_gene
442025,442364,339,-1,0,chrXIII,known_gene
431768,432125,357,-1,0,chrXIII,known_gene
416195,420029,3834,-1,0,chrXIII,known_gene
398516,398864,348,-1,0,chrXIII,novel_orf
388358,388730,372,-1,0,chrXIII,known_gene
387314,388244,930,-1,0,chrXIII,known_gene
380345,382898,2553,-1,0,chrXIII,known_gene
368093,370517,2424,-1,0,chrXIII,known_gene
365771,366191,420,-1,0,chrXIII,known_gene
361304,362627,1323,-1,0,chrXIII,novel_orf
347510,348260,750,-1,0,chrXIII,known_gene
344402,346517,2115,-1,0,chrXIII,known_gene
341855,343520,1665,-1,0,chrXIII,known_gene
319436,321017,1581,-1,0,chrXIII,known_gene
295178,296738,1560,-1,0,chrXIII,known_gene
280589,282584,1995,-1,0,chrXIII,known_gene
269018,271136,2118,-1,0,chrXIII,known_gene
261704,262685,981,-1,0,chrXIII,known_gene
256091,258416,2325,-1,0,chrXIII,known_gene
241988,243029,1041,-1,0,chrXIII,known_gene
234770,235952,1182,-1,0,chrXIII,known_gene
229733,230813,1080,-1,0,chrXIII,known_gene
224405,224951,546,-1,0,chrXIII,known_gene
215639,215999,360,-1,0,chrXIII,novel_orf
214085,214421,336,-1,0,chrXIII,known_gene
194912,195755,843,-1,0,chrXIII,known_gene
169115,169754,639,-1,0,chrXIII,known_gene
160022,160412,390,-1,0,chrXIII,known_gene
153218,158258,5040,-1,0,chrXIII,known_gene
148952,151532,2580,-1,0,chrXIII,known_gene
140423,141533,1110,-1,0,chrXIII,known_gene
115733,118898,3165,-1,0,chrXIII,known_gene
97940,98675,735,-1,0,chrXIII,known_gene
94430,95369,939,-1,0,chrXIII,known_gene
91040,91409,369,-1,0,chrXIII,known_gene
87122,90731,3609,-1,0,chrXIII,known_gene
76697,77021,324,-1,0,chrXIII,known_gene
70655,71351,696,-1,0,chrXIII,novel_orf
69734,70088,354,-1,0,chrXIII,known_gene
53291,53834,543,-1,0,chrXIII,novel_orf
50030,50954,924,-1,0,chrXIII,known_gene
47900,48218,318,-1,0,chrXIII,novel_orf
28265,29807,1542,-1,0,chrXIII,known_gene
15134,16676,1542,-1,0,chrXIII,known_gene
917578,917896,318,-1,1,chrXIII,known_gene
892987,895426,2439,-1,1,chrXIII,known_gene
878779,879130,351,-1,1,chrXIII,known_gene
873418,873733,315,-1,1,chrXIII,known_gene
865558,867091,1533,-1,1,chrXIII,known_gene
854884,855226,342,-1,1,chrXIII,novel_orf
845647,846244,597,-1,1,chrXIII,novel_orf
824728,826351,1623,-1,1,chrXIII,known_gene
815650,818581,2931,-1,1,chrXIII,known_gene
814363,815311,948,-1,1,chrXIII,known_gene
790204,793369,3165,-1,1,chrXIII,known_gene
775945,777190,1245,-1,1,chrXIII,known_gene
754837,756166,1329,-1,1,chrXIII,known_gene
749929,751240,1311,-1,1,chrXIII,known_gene
748261,749677,1416,-1,1,chrXIII,known_gene
741511,742735,1224,-1,1,chrXIII,known_gene
694309,694624,315,-1,1,chrXIII,novel_orf
690694,693043,2349,-1,1,chrXIII,known_gene
647173,647518,345,-1,1,chrXIII,novel_orf
626920,627808,888,-1,1,chrXIII,known_gene
601561,603082,1521,-1,1,chrXIII,known_gene
597331,599158,1827,-1,1,chrXIII,known_gene
588331,588754,423,-1,1,chrXIII,known_gene
578950,583921,4971,-1,1,chrXIII,known_gene
571276,572044,768,-1,1,chrXIII,known_gene
565573,565909,336,-1,1,chrXIII,known_gene
564445,564829,384,-1,1,chrXIII,novel_orf
561955,562528,573,-1,1,chrXIII,known_gene
553483,553789,306,-1,1,chrXIII,novel_orf
542977,544963,1986,-1,1,chrXIII,known_gene
534943,535570,627,-1,1,chrXIII,known_gene
522328,523345,1017,-1,1,chrXIII,known_gene
510700,511075,375,-1,1,chrXIII,known_gene
496342,497449,1107,-1,1,chrXIII,known_gene
492403,493792,1389,-1,1,chrXIII,known_gene
490393,491992,1599,-1,1,chrXIII,known_gene
478300,480190,1890,-1,1,chrXIII,known_gene
473419,475453,2034,-1,1,chrXIII,known_gene
463933,464827,894,-1,1,chrXIII,known_gene
443413,445102,1689,-1,1,chrXIII,known_gene
430078,431095,1017,-1,1,chrXIII,known_gene
421483,422149,666,-1,1,chrXIII,known_gene
415687,416053,366,-1,1,chrXIII,known_gene
413035,413473,438,-1,1,chrXIII,known_gene
412267,412873,606,-1,1,chrXIII,known_gene
410761,411265,504,-1,1,chrXIII,known_gene
397354,397690,336,-1,1,chrXIII,novel_orf
395053,396379,1326,-1,1,chrXIII,known_gene
391531,392515,984,-1,1,chrXIII,known_gene
380068,380434,366,-1,1,chrXIII,known_gene
377002,378325,1323,-1,1,chrXIII,novel_orf
357358,360826,3468,-1,1,chrXIII,novel_orf
350965,351973,1008,-1,1,chrXIII,known_gene
348643,349522,879,-1,1,chrXIII,known_gene
324235,325435,1200,-1,1,chrXIII,known_gene
317164,318418,1254,-1,1,chrXIII,known_gene
303235,305593,2358,-1,1,chrXIII,known_gene
300868,302485,1617,-1,1,chrXIII,known_gene
274777,275353,576,-1,1,chrXIII,novel_orf
255331,255754,423,-1,1,chrXIII,novel_orf
254497,254932,435,-1,1,chrXIII,novel_orf
250303,250672,369,-1,1,chrXIII,novel_orf
245536,245914,378,-1,1,chrXIII,known_gene
244543,244858,315,-1,1,chrXIII,novel_orf
226993,228664,1671,-1,1,chrXIII,known_gene
204385,205408,1023,-1,1,chrXIII,known_gene
202774,204103,1329,-1,1,chrXIII,known_gene
190243,191767,1524,-1,1,chrXIII,known_gene
180016,181075,1059,-1,1,chrXIII,known_gene
165532,167308,1776,-1,1,chrXIII,known_gene
163705,164176,471,-1,1,chrXIII,known_gene
162193,163216,1023,-1,1,chrXIII,known_gene
156262,156577,315,-1,1,chrXIII,known_gene
145138,145876,738,-1,1,chrXIII,known_gene
129748,131572,1824,-1,1,chrXIII,known_gene
124729,129367,4638,-1,1,chrXIII,known_gene
120088,121324,1236,-1,1,chrXIII,known_gene
102922,103240,318,-1,1,chrXIII,novel_orf
99793,101050,1257,-1,1,chrXIII,known_gene
92662,93019,357,-1,1,chrXIII,novel_orf
78334,79690,1356,-1,1,chrXIII,known_gene
62581,67549,4968,-1,1,chrXIII,known_gene
57865,58687,822,-1,1,chrXIII,known_gene
55264,56425,1161,-1,1,chrXIII,known_gene
40186,41794,1608,-1,1,chrXIII,known_gene
38440,38791,351,-1,1,chrXIII,novel_orf
11482,13174,1692,-1,1,chrXIII,known_gene
3868,4684,816,-1,1,chrXIII,known_gene
460,3454,2994,-1,1,chrXIII,known_gene
923493,923802,309,-1,2,chrXIII,known_gene
912879,914538,1659,-1,2,chrXIII,known_gene
908862,909366,504,-1,2,chrXIII,novel_orf
907794,908841,1047,-1,2,chrXIII,novel_orf
907320,907629,309,-1,2,chrXIII,known_gene
905661,905973,312,-1,2,chrXIII,known_gene
896913,897603,690,-1,2,chrXIII,known_gene
888951,892221,3270,-1,2,chrXIII,known_gene
888303,888651,348,-1,2,chrXIII,novel_orf
886182,886572,390,-1,2,chrXIII,known_gene
876348,876648,300,-1,2,chrXIII,novel_orf
870072,872625,2553,-1,2,chrXIII,known_gene
864411,865350,939,-1,2,chrXIII,known_gene
862005,862341,336,-1,2,chrXIII,novel_orf
833355,835098,1743,-1,2,chrXIII,known_gene
809622,810777,1155,-1,2,chrXIII,known_gene
802887,804222,1335,-1,2,chrXIII,known_gene
796539,797925,1386,-1,2,chrXIII,known_gene
784620,788883,4263,-1,2,chrXIII,known_gene
782619,784281,1662,-1,2,chrXIII,known_gene
779628,782031,2403,-1,2,chrXIII,known_gene
775314,775719,405,-1,2,chrXIII,known_gene
763350,768039,4689,-1,2,chrXIII,known_gene
703578,706887,3309,-1,2,chrXIII,known_gene
671886,674766,2880,-1,2,chrXIII,known_gene
670062,671325,1263,-1,2,chrXIII,known_gene
665844,666588,744,-1,2,chrXIII,known_gene
640914,645258,4344,-1,2,chrXIII,known_gene
624531,625167,636,-1,2,chrXIII,known_gene
607827,608211,384,-1,2,chrXIII,known_gene
603867,605520,1653,-1,2,chrXIII,known_gene
565998,568182,2184,-1,2,chrXIII,known_gene
549735,550044,309,-1,2,chrXIII,known_gene
537126,537441,315,-1,2,chrXIII,novel_orf
509733,510348,615,-1,2,chrXIII,known_gene
507501,509280,1779,-1,2,chrXIII,known_gene
502143,502734,591,-1,2,chrXIII,known_gene
501249,501891,642,-1,2,chrXIII,known_gene
500115,500688,573,-1,2,chrXIII,known_gene
499455,499755,300,-1,2,chrXIII,known_gene
489522,489852,330,-1,2,chrXIII,novel_orf
475896,477606,1710,-1,2,chrXIII,known_gene
468444,469476,1032,-1,2,chrXIII,known_gene
460770,462609,1839,-1,2,chrXIII,known_gene
459423,460527,1104,-1,2,chrXIII,known_gene
457284,457959,675,-1,2,chrXIII,known_gene
456327,456633,306,-1,2,chrXIII,novel_orf
450057,451365,1308,-1,2,chrXIII,known_gene
445608,448086,2478,-1,2,chrXIII,known_gene
426711,429627,2916,-1,2,chrXIII,known_gene
422502,424728,2226,-1,2,chrXIII,known_gene
407034,407541,507,-1,2,chrXIII,novel_orf
406665,407016,351,-1,2,chrXIII,novel_orf
404322,405573,1251,-1,2,chrXIII,known_gene
386100,387021,921,-1,2,chrXIII,known_gene
383460,384018,558,-1,2,chrXIII,novel_orf
373056,376524,3468,-1,2,chrXIII,novel_orf
363363,366705,3342,-1,2,chrXIII,known_gene
359244,359556,312,-1,2,chrXIII,novel_orf
356718,357045,327,-1,2,chrXIII,novel_orf
339417,340722,1305,-1,2,chrXIII,known_gene
332211,334743,2532,-1,2,chrXIII,known_gene
328659,330231,1572,-1,2,chrXIII,known_gene
326310,326742,432,-1,2,chrXIII,novel_orf
317658,318099,441,-1,2,chrXIII,known_gene
283080,283548,468,-1,2,chrXIII,novel_orf
277560,279681,2121,-1,2,chrXIII,known_gene
251838,252990,1152,-1,2,chrXIII,known_gene
250674,251001,327,-1,2,chrXIII,known_gene
246894,247428,534,-1,2,chrXIII,known_gene
239457,241536,2079,-1,2,chrXIII,known_gene
212514,214029,1515,-1,2,chrXIII,known_gene
209427,209826,399,-1,2,chrXIII,known_gene
206427,208860,2433,-1,2,chrXIII,known_gene
174219,178305,4086,-1,2,chrXIII,known_gene
147504,148683,1179,-1,2,chrXIII,known_gene
139062,139917,855,-1,2,chrXIII,known_gene
112512,115347,2835,-1,2,chrXIII,known_gene
95790,97371,1581,-1,2,chrXIII,known_gene
85986,86739,753,-1,2,chrXIII,known_gene
85041,85353,312,-1,2,chrXIII,novel_orf
82218,82620,402,-1,2,chrXIII,known_gene
81480,82113,633,-1,2,chrXIII,known_gene
74397,77040,2643,-1,2,chrXIII,known_gene
69408,69726,318,-1,2,chrXIII,known_gene
58938,62322,3384,-1,2,chrXIII,known_gene
42042,43575,1533,-1,2,chrXIII,known_gene
26037,26418,381,-1,2,chrXIII,known_gene
24036,25800,1764,-1,2,chrXIII,known_gene
22047,23433,1386,-1,2,chrXIII,known_gene
20760,21699,939,-1,2,chrXIII,known_gene
19059,20535,1476,-1,2,chrXIII,known_gene
1548,2124,576,-1,2,chrXIII,known_gene
11451,12129,678,1,0,chrXIV,known_gene
13266,14163,897,1,0,chrXIV,known_gene
34695,37422,2727,1,0,chrXIV,known_gene
61509,61857,348,1,0,chrXIV,known_gene
66516,68445,1929,1,0,chrXIV,known_gene
72216,72594,378,1,0,chrXIV,novel_orf
76272,76587,315,1,0,chrXIV,known_gene
86217,87240,1023,1,0,chrXIV,known_gene
110916,112902,1986,1,0,chrXIV,known_gene
117348,118809,1461,1,0,chrXIV,known_gene
138549,140385,1836,1,0,chrXIV,known_gene
140877,144078,3201,1,0,chrXIV,known_gene
164502,167097,2595,1,0,chrXIV,known_gene
182874,185178,2304,1,0,chrXIV,known_gene
200481,201933,1452,1,0,chrXIV,known_gene
220644,221421,777,1,0,chrXIV,known_gene
240330,241311,981,1,0,chrXIV,known_gene
244467,245430,963,1,0,chrXIV,known_gene
245616,246216,600,1,0,chrXIV,known_gene
254676,255051,375,1,0,chrXIV,known_gene
276501,279897,3396,1,0,chrXIV,known_gene
280431,281505,1074,1,0,chrXIV,known_gene
284259,285888,1629,1,0,chrXIV,known_gene
289497,291876,2379,1,0,chrXIV,known_gene
302679,303402,723,1,0,chrXIV,known_gene
308073,308646,573,1,0,chrXIV,known_gene
310635,315882,5247,1,0,chrXIV,known_gene
351714,352017,303,1,0,chrXIV,known_gene
359595,360639,1044,1,0,chrXIV,known_gene
393828,394167,339,1,0,chrXIV,known_gene
412770,413199,429,1,0,chrXIV,known_gene
427734,429753,2019,1,0,chrXIV,known_gene
430086,434493,4407,1,0,chrXIV,known_gene
446370,446781,411,1,0,chrXIV,novel_orf
450870,452073,1203,1,0,chrXIV,known_gene
456564,457143,579,1,0,chrXIV,known_gene
467130,469623,2493,1,0,chrXIV,known_gene
483555,485310,1755,1,0,chrXIV,known_gene
488385,490116,1731,1,0,chrXIV,known_gene
499680,500256,576,1,0,chrXIV,known_gene
516402,516735,333,1,0,chrXIV,known_gene
517248,517842,594,1,0,chrXIV,known_gene
521256,524706,3450,1,0,chrXIV,novel_orf
529941,531411,1470,1,0,chrXIV,known_gene
545400,545877,477,1,0,chrXIV,known_gene
557019,557658,639,1,0,chrXIV,known_gene
576726,577038,312,1,0,chrXIV,known_gene
579579,581616,2037,1,0,chrXIV,known_gene
581919,583374,1455,1,0,chrXIV,known_gene
593226,595347,2121,1,0,chrXIV,known_gene
606318,609453,3135,1,0,chrXIV,known_gene
614820,616083,1263,1,0,chrXIV,known_gene
623331,624621,1290,1,0,chrXIV,known_gene
640395,642381,1986,1,0,chrXIV,known_gene
643743,644193,450,1,0,chrXIV,known_gene
652464,653103,639,1,0,chrXIV,known_gene
664269,664944,675,1,0,chrXIV,known_gene
668376,669591,1215,1,0,chrXIV,known_gene
672408,672969,561,1,0,chrXIV,known_gene
674922,675876,954,1,0,chrXIV,known_gene
676176,677103,927,1,0,chrXIV,known_gene
678798,680454,1656,1,0,chrXIV,known_gene
680904,681273,369,1,0,chrXIV,novel_orf
703698,705876,2178,1,0,chrXIV,known_gene
707787,708195,408,1,0,chrXIV,known_gene
708522,711204,2682,1,0,chrXIV,known_gene
719679,720018,339,1,0,chrXIV,novel_orf
739950,742110,2160,1,0,chrXIV,known_gene
772656,774351,1695,1,0,chrXIV,known_gene
781917,782280,363,1,0,chrXIV,known_gene
733,1216,483,1,1,chrXIV,known_gene
1516,2092,576,1,1,chrXIV,known_gene
4249,4600,351,1,1,chrXIV,novel_orf
8329,9475,1146,1,1,chrXIV,known_gene
37699,38554,855,1,1,chrXIV,known_gene
38641,39082,441,1,1,chrXIV,known_gene
40618,42016,1398,1,1,chrXIV,known_gene
44446,45214,768,1,1,chrXIV,known_gene
65743,66052,309,1,1,chrXIV,known_gene
68914,71443,2529,1,1,chrXIV,known_gene
76945,78520,1575,1,1,chrXIV,known_gene
91993,94801,2808,1,1,chrXIV,known_gene
96172,96544,372,1,1,chrXIV,known_gene
107686,108274,588,1,1,chrXIV,known_gene
108466,108928,462,1,1,chrXIV,known_gene
136348,136720,372,1,1,chrXIV,novel_orf
137698,138094,396,1,1,chrXIV,known_gene
144244,144664,420,1,1,chrXIV,known_gene
170017,171286,1269,1,1,chrXIV,known_gene
185578,186349,771,1,1,chrXIV,known_gene
188050,190957,2907,1,1,chrXIV,known_gene
191323,196102,4779,1,1,chrXIV,known_gene
206929,209854,2925,1,1,chrXIV,known_gene
210232,211513,1281,1,1,chrXIV,known_gene
211921,214600,2679,1,1,chrXIV,known_gene
222238,222649,411,1,1,chrXIV,known_gene
229093,229714,621,1,1,chrXIV,known_gene
234412,235714,1302,1,1,chrXIV,known_gene
238237,240001,1764,1,1,chrXIV,known_gene
250930,251743,813,1,1,chrXIV,known_gene
252058,253900,1842,1,1,chrXIV,known_gene
255352,256630,1278,1,1,chrXIV,known_gene
282394,283009,615,1,1,chrXIV,known_gene
332596,334867,2271,1,1,chrXIV,known_gene
336544,337609,1065,1,1,chrXIV,known_gene
340351,340858,507,1,1,chrXIV,known_gene
346312,347542,1230,1,1,chrXIV,known_gene
378766,379225,459,1,1,chrXIV,known_gene
383986,386848,2862,1,1,chrXIV,known_gene
387226,389767,2541,1,1,chrXIV,known_gene
394684,397678,2994,1,1,chrXIV,known_gene
406357,408022,1665,1,1,chrXIV,known_gene
408340,409909,1569,1,1,chrXIV,known_gene
413638,414943,1305,1,1,chrXIV,known_gene
415948,416281,333,1,1,chrXIV,known_gene
418963,419509,546,1,1,chrXIV,known_gene
420097,420778,681,1,1,chrXIV,known_gene
423466,423805,339,1,1,chrXIV,novel_orf
434998,437140,2142,1,1,chrXIV,known_gene
447610,449374,1764,1,1,chrXIV,known_gene
452407,456130,3723,1,1,chrXIV,known_gene
466333,466642,309,1,1,chrXIV,known_gene
471376,472861,1485,1,1,chrXIV,known_gene
479767,480991,1224,1,1,chrXIV,known_gene
481390,482977,1587,1,1,chrXIV,known_gene
484249,484825,576,1,1,chrXIV,known_gene
501514,502777,1263,1,1,chrXIV,known_gene
507757,508702,945,1,1,chrXIV,known_gene
522508,522820,312,1,1,chrXIV,novel_orf
531724,532186,462,1,1,chrXIV,known_gene
541240,541645,405,1,1,chrXIV,novel_orf
542962,544978,2016,1,1,chrXIV,known_gene
558307,558661,354,1,1,chrXIV,novel_orf
559813,560479,666,1,1,chrXIV,known_gene
572998,573853,855,1,1,chrXIV,known_gene
610054,611665,1611,1,1,chrXIV,known_gene
636985,638854,1869,1,1,chrXIV,known_gene
647431,648937,1506,1,1,chrXIV,known_gene
653386,654541,1155,1,1,chrXIV,known_gene
665338,667267,1929,1,1,chrXIV,known_gene
670417,672118,1701,1,1,chrXIV,known_gene
687634,689998,2364,1,1,chrXIV,known_gene
706138,707608,1470,1,1,chrXIV,known_gene
734290,735733,1443,1,1,chrXIV,known_gene
770737,771088,351,1,1,chrXIV,novel_orf
1502,2009,507,1,2,chrXIV,known_gene
2378,2714,336,1,2,chrXIV,novel_orf
14831,15854,1023,1,2,chrXIV,known_gene
24047,27173,3126,1,2,chrXIV,known_gene
31049,31445,396,1,2,chrXIV,known_gene
31943,33188,1245,1,2,chrXIV,known_gene
49448,49763,315,1,2,chrXIV,novel_orf
52544,53924,1380,1,2,chrXIV,known_gene
58154,58808,654,1,2,chrXIV,known_gene
60296,61550,1254,1,2,chrXIV,known_gene
80639,82541,1902,1,2,chrXIV,known_gene
82805,84017,1212,1,2,chrXIV,known_gene
87896,88736,840,1,2,chrXIV,known_gene
90302,91424,1122,1,2,chrXIV,known_gene
95222,96080,858,1,2,chrXIV,known_gene
113270,116453,3183,1,2,chrXIV,known_gene
119267,120998,1731,1,2,chrXIV,known_gene
122882,126599,3717,1,2,chrXIV,known_gene
135770,136070,300,1,2,chrXIV,novel_orf
148211,154880,6669,1,2,chrXIV,known_gene
155099,156539,1440,1,2,chrXIV,known_gene
175409,179348,3939,1,2,chrXIV,known_gene
202427,204872,2445,1,2,chrXIV,known_gene
205187,206567,1380,1,2,chrXIV,known_gene
214922,215801,879,1,2,chrXIV,known_gene
227333,228854,1521,1,2,chrXIV,known_gene
241688,244172,2484,1,2,chrXIV,known_gene
247460,249809,2349,1,2,chrXIV,known_gene
254417,255017,600,1,2,chrXIV,known_gene
259568,260456,888,1,2,chrXIV,known_gene
274367,276044,1677,1,2,chrXIV,known_gene
282545,282950,405,1,2,chrXIV,known_gene
286307,287609,1302,1,2,chrXIV,known_gene
287771,289067,1296,1,2,chrXIV,known_gene
298334,299558,1224,1,2,chrXIV,known_gene
315977,316373,396,1,2,chrXIV,known_gene
323831,325052,1221,1,2,chrXIV,known_gene
339611,340208,597,1,2,chrXIV,known_gene
342515,343340,825,1,2,chrXIV,known_gene
343856,344306,450,1,2,chrXIV,novel_orf
349250,349658,408,1,2,chrXIV,known_gene
357452,358952,1500,1,2,chrXIV,known_gene
366740,368321,1581,1,2,chrXIV,known_gene
370367,371645,1278,1,2,chrXIV,known_gene
375320,378491,3171,1,2,chrXIV,known_gene
381479,382202,723,1,2,chrXIV,known_gene
382358,383663,1305,1,2,chrXIV,known_gene
391811,392147,336,1,2,chrXIV,novel_orf
392891,394370,1479,1,2,chrXIV,known_gene
401039,402521,1482,1,2,chrXIV,known_gene
421304,421685,381,1,2,chrXIV,novel_orf
424154,424583,429,1,2,chrXIV,known_gene
437612,438317,705,1,2,chrXIV,known_gene
449867,450530,663,1,2,chrXIV,known_gene
457703,461990,4287,1,2,chrXIV,known_gene
462410,465947,3537,1,2,chrXIV,known_gene
473297,476012,2715,1,2,chrXIV,known_gene
485606,486479,873,1,2,chrXIV,known_gene
490316,491240,924,1,2,chrXIV,known_gene
491522,492971,1449,1,2,chrXIV,known_gene
503723,505484,1761,1,2,chrXIV,known_gene
510539,512396,1857,1,2,chrXIV,known_gene
519455,520778,1323,1,2,chrXIV,novel_orf
526085,529583,3498,1,2,chrXIV,known_gene
532658,533870,1212,1,2,chrXIV,known_gene
538172,539819,1647,1,2,chrXIV,known_gene
542303,542822,519,1,2,chrXIV,known_gene
544226,544544,318,1,2,chrXIV,known_gene
548099,549290,1191,1,2,chrXIV,known_gene
553379,554750,1371,1,2,chrXIV,known_gene
555047,556832,1785,1,2,chrXIV,known_gene
570476,572315,1839,1,2,chrXIV,known_gene
574505,575351,846,1,2,chrXIV,known_gene
578678,578996,318,1,2,chrXIV,known_gene
602906,604268,1362,1,2,chrXIV,known_gene
613634,614360,726,1,2,chrXIV,known_gene
620066,620978,912,1,2,chrXIV,known_gene
627455,628616,1161,1,2,chrXIV,known_gene
635942,636383,441,1,2,chrXIV,known_gene
642689,643439,750,1,2,chrXIV,known_gene
649298,649844,546,1,2,chrXIV,novel_orf
662912,663581,669,1,2,chrXIV,known_gene
673820,674123,303,1,2,chrXIV,novel_orf
686009,687116,1107,1,2,chrXIV,known_gene
690320,691286,966,1,2,chrXIV,known_gene
695594,697484,1890,1,2,chrXIV,known_gene
699689,700460,771,1,2,chrXIV,known_gene
701237,701666,429,1,2,chrXIV,known_gene
701894,703085,1191,1,2,chrXIV,known_gene
711629,712811,1182,1,2,chrXIV,known_gene
717206,717530,324,1,2,chrXIV,novel_orf
736802,738545,1743,1,2,chrXIV,known_gene
746942,748766,1824,1,2,chrXIV,known_gene
765374,769376,4002,1,2,chrXIV,known_gene
779915,781040,1125,1,2,chrXIV,known_gene
777601,778738,1137,-1,0,chrXIV,known_gene
761122,762592,1470,-1,0,chrXIV,known_gene
760066,760885,819,-1,0,chrXIV,known_gene
753724,755035,1311,-1,0,chrXIV,known_gene
750349,753700,3351,-1,0,chrXIV,known_gene
731617,733303,1686,-1,0,chrXIV,known_gene
728425,730186,1761,-1,0,chrXIV,known_gene
723355,724306,951,-1,0,chrXIV,known_gene
722293,723112,819,-1,0,chrXIV,known_gene
716779,718327,1548,-1,0,chrXIV,known_gene
706186,706585,399,-1,0,chrXIV,novel_orf
700540,701659,1119,-1,0,chrXIV,known_gene
694360,694822,462,-1,0,chrXIV,known_gene
673273,674689,1416,-1,0,chrXIV,known_gene
649027,651712,2685,-1,0,chrXIV,known_gene
639181,640114,933,-1,0,chrXIV,known_gene
636046,636373,327,-1,0,chrXIV,novel_orf
633007,633856,849,-1,0,chrXIV,known_gene
626173,627142,969,-1,0,chrXIV,known_gene
618994,619399,405,-1,0,chrXIV,known_gene
616210,618241,2031,-1,0,chrXIV,known_gene
602137,602476,339,-1,0,chrXIV,known_gene
599935,601774,1839,-1,0,chrXIV,known_gene
598375,599230,855,-1,0,chrXIV,known_gene
588262,591160,2898,-1,0,chrXIV,known_gene
577204,578773,1569,-1,0,chrXIV,known_gene
566383,567820,1437,-1,0,chrXIV,novel_orf
555148,555583,435,-1,0,chrXIV,novel_orf
517993,518845,852,-1,0,chrXIV,known_gene
505867,507097,1230,-1,0,chrXIV,known_gene
495700,498289,2589,-1,0,chrXIV,known_gene
492502,492868,366,-1,0,chrXIV,novel_orf
485968,486448,480,-1,0,chrXIV,novel_orf
447754,448066,312,-1,0,chrXIV,novel_orf
424894,426754,1860,-1,0,chrXIV,known_gene
420943,424495,3552,-1,0,chrXIV,known_gene
401032,401518,486,-1,0,chrXIV,known_gene
398683,400537,1854,-1,0,chrXIV,known_gene
393466,393820,354,-1,0,chrXIV,novel_orf
390145,392167,2022,-1,0,chrXIV,known_gene
374170,374692,522,-1,0,chrXIV,known_gene
371881,372226,345,-1,0,chrXIV,known_gene
360916,361486,570,-1,0,chrXIV,known_gene
352819,355042,2223,-1,0,chrXIV,known_gene
349906,350671,765,-1,0,chrXIV,known_gene
349366,349756,390,-1,0,chrXIV,known_gene
341068,341968,900,-1,0,chrXIV,known_gene
326740,330073,3333,-1,0,chrXIV,known_gene
325264,326320,1056,-1,0,chrXIV,known_gene
316168,317671,1503,-1,0,chrXIV,known_gene
315628,315997,369,-1,0,chrXIV,known_gene
308956,310057,1101,-1,0,chrXIV,known_gene
303685,304615,930,-1,0,chrXIV,known_gene
299653,300649,996,-1,0,chrXIV,known_gene
292192,292669,477,-1,0,chrXIV,known_gene
282508,282871,363,-1,0,chrXIV,novel_orf
271522,272308,786,-1,0,chrXIV,known_gene
270274,271171,897,-1,0,chrXIV,known_gene
267607,269593,1986,-1,0,chrXIV,known_gene
264925,266530,1605,-1,0,chrXIV,known_gene
260626,263203,2577,-1,0,chrXIV,known_gene
259438,260050,612,-1,0,chrXIV,known_gene
258154,258577,423,-1,0,chrXIV,known_gene
231067,233695,2628,-1,0,chrXIV,known_gene
219136,220201,1065,-1,0,chrXIV,known_gene
217522,218662,1140,-1,0,chrXIV,known_gene
215986,217042,1056,-1,0,chrXIV,known_gene
205987,206323,336,-1,0,chrXIV,novel_orf
203917,204457,540,-1,0,chrXIV,novel_orf
202627,202945,318,-1,0,chrXIV,novel_orf
181360,182608,1248,-1,0,chrXIV,known_gene
160630,164320,3690,-1,0,chrXIV,known_gene
151255,151630,375,-1,0,chrXIV,novel_orf
131404,131716,312,-1,0,chrXIV,known_gene
121117,122170,1053,-1,0,chrXIV,known_gene
117832,118159,327,-1,0,chrXIV,novel_orf
100909,102232,1323,-1,0,chrXIV,novel_orf
81607,81937,330,-1,0,chrXIV,novel_orf
78658,80260,1602,-1,0,chrXIV,known_gene
61957,62260,303,-1,0,chrXIV,known_gene
58897,59791,894,-1,0,chrXIV,known_gene
54121,55897,1776,-1,0,chrXIV,known_gene
49396,51688,2292,-1,0,chrXIV,known_gene
45307,48022,2715,-1,0,chrXIV,known_gene
42070,43177,1107,-1,0,chrXIV,known_gene
38830,39130,300,-1,0,chrXIV,known_gene
33820,34126,306,-1,0,chrXIV,known_gene
28738,31378,2640,-1,0,chrXIV,known_gene
19540,22633,3093,-1,0,chrXIV,known_gene
16117,17248,1131,-1,0,chrXIV,known_gene
370,5758,5388,-1,0,chrXIV,known_gene
770439,771468,1029,-1,1,chrXIV,known_gene
755745,759099,3354,-1,1,chrXIV,known_gene
721119,721506,387,-1,1,chrXIV,known_gene
713022,713655,633,-1,1,chrXIV,known_gene
693018,694047,1029,-1,1,chrXIV,known_gene
670761,671307,546,-1,1,chrXIV,novel_orf
665517,665967,450,-1,1,chrXIV,novel_orf
654672,661374,6702,-1,1,chrXIV,known_gene
644319,646950,2631,-1,1,chrXIV,known_gene
636930,637335,405,-1,1,chrXIV,known_gene
621312,622428,1116,-1,1,chrXIV,known_gene
611835,613170,1335,-1,1,chrXIV,known_gene
609132,609510,378,-1,1,chrXIV,known_gene
591426,592899,1473,-1,1,chrXIV,known_gene
587106,587847,741,-1,1,chrXIV,known_gene
584319,585291,972,-1,1,chrXIV,known_gene
568521,569691,1170,-1,1,chrXIV,known_gene
562386,566427,4041,-1,1,chrXIV,novel_orf
557919,559002,1083,-1,1,chrXIV,known_gene
539910,541881,1971,-1,1,chrXIV,known_gene
534078,534549,471,-1,1,chrXIV,known_gene
518793,519156,363,-1,1,chrXIV,known_gene
512667,514935,2268,-1,1,chrXIV,known_gene
507744,508044,300,-1,1,chrXIV,novel_orf
496071,496380,309,-1,1,chrXIV,known_gene
486765,488124,1359,-1,1,chrXIV,known_gene
476931,478032,1101,-1,1,chrXIV,known_gene
476187,476619,432,-1,1,chrXIV,known_gene
470052,471102,1050,-1,1,chrXIV,known_gene
461007,461316,309,-1,1,chrXIV,novel_orf
452967,453627,660,-1,1,chrXIV,novel_orf
435609,435930,321,-1,1,chrXIV,novel_orf
420453,420765,312,-1,1,chrXIV,novel_orf
419013,419826,813,-1,1,chrXIV,known_gene
417825,418488,663,-1,1,chrXIV,known_gene
412683,413055,372,-1,1,chrXIV,known_gene
410118,412053,1935,-1,1,chrXIV,known_gene
402651,405564,2913,-1,1,chrXIV,known_gene
398022,398370,348,-1,1,chrXIV,known_gene
385407,385833,426,-1,1,chrXIV,novel_orf
379557,380604,1047,-1,1,chrXIV,known_gene
378831,379182,351,-1,1,chrXIV,novel_orf
372450,373581,1131,-1,1,chrXIV,known_gene
356793,357186,393,-1,1,chrXIV,known_gene
343635,345276,1641,-1,1,chrXIV,known_gene
322218,323565,1347,-1,1,chrXIV,known_gene
295959,297627,1668,-1,1,chrXIV,known_gene
293136,295509,2373,-1,1,chrXIV,known_gene
272709,273615,906,-1,1,chrXIV,known_gene
263712,264453,741,-1,1,chrXIV,known_gene
252126,252495,369,-1,1,chrXIV,novel_orf
246459,247104,645,-1,1,chrXIV,known_gene
235995,237663,1668,-1,1,chrXIV,known_gene
229326,229650,324,-1,1,chrXIV,novel_orf
222723,224469,1746,-1,1,chrXIV,known_gene
209547,209979,432,-1,1,chrXIV,known_gene
198501,199977,1476,-1,1,chrXIV,known_gene
196425,197943,1518,-1,1,chrXIV,known_gene
186345,186885,540,-1,1,chrXIV,known_gene
172587,174315,1728,-1,1,chrXIV,known_gene
168042,169248,1206,-1,1,chrXIV,known_gene
167328,167790,462,-1,1,chrXIV,known_gene
156858,157455,597,-1,1,chrXIV,known_gene
146895,147840,945,-1,1,chrXIV,known_gene
144279,145125,846,-1,1,chrXIV,known_gene
135939,137661,1722,-1,1,chrXIV,known_gene
126804,129084,2280,-1,1,chrXIV,known_gene
105183,106695,1512,-1,1,chrXIV,known_gene
96963,100431,3468,-1,1,chrXIV,novel_orf
93072,93378,306,-1,1,chrXIV,novel_orf
84168,85815,1647,-1,1,chrXIV,known_gene
56445,57573,1128,-1,1,chrXIV,known_gene
51906,52524,618,-1,1,chrXIV,known_gene
43323,44280,957,-1,1,chrXIV,known_gene
41049,41379,330,-1,1,chrXIV,novel_orf
38706,40329,1623,-1,1,chrXIV,known_gene
27336,28347,1011,-1,1,chrXIV,known_gene
22833,23274,441,-1,1,chrXIV,known_gene
18000,19302,1302,-1,1,chrXIV,known_gene
12207,12876,669,-1,1,chrXIV,known_gene
1455,2031,576,-1,1,chrXIV,known_gene
774791,776300,1509,-1,2,chrXIV,known_gene
749135,750008,873,-1,2,chrXIV,known_gene
744359,745343,984,-1,2,chrXIV,known_gene
742880,743540,660,-1,2,chrXIV,known_gene
741158,741488,330,-1,2,chrXIV,novel_orf
733355,734069,714,-1,2,chrXIV,known_gene
719345,720647,1302,-1,2,chrXIV,known_gene
714047,715388,1341,-1,2,chrXIV,known_gene
707765,708101,336,-1,2,chrXIV,novel_orf
705503,705845,342,-1,2,chrXIV,novel_orf
697613,699431,1818,-1,2,chrXIV,known_gene
680693,685433,4740,-1,2,chrXIV,known_gene
677198,678488,1290,-1,2,chrXIV,known_gene
672701,673061,360,-1,2,chrXIV,known_gene
669773,670193,420,-1,2,chrXIV,known_gene
667409,668222,813,-1,2,chrXIV,known_gene
664301,664691,390,-1,2,chrXIV,novel_orf
652202,652502,300,-1,2,chrXIV,novel_orf
634343,635297,954,-1,2,chrXIV,known_gene
629621,631061,1440,-1,2,chrXIV,known_gene
624974,625829,855,-1,2,chrXIV,known_gene
623729,624095,366,-1,2,chrXIV,novel_orf
618506,619565,1059,-1,2,chrXIV,known_gene
606998,607451,453,-1,2,chrXIV,novel_orf
595622,597539,1917,-1,2,chrXIV,known_gene
575639,576050,411,-1,2,chrXIV,known_gene
549467,551987,2520,-1,2,chrXIV,known_gene
545588,545909,321,-1,2,chrXIV,known_gene
535280,537911,2631,-1,2,chrXIV,known_gene
515762,516713,951,-1,2,chrXIV,known_gene
508775,510212,1437,-1,2,chrXIV,known_gene
493955,494297,342,-1,2,chrXIV,known_gene
478565,479165,600,-1,2,chrXIV,known_gene
456692,457169,477,-1,2,chrXIV,known_gene
444911,446840,1929,-1,2,chrXIV,known_gene
441365,442358,993,-1,2,chrXIV,known_gene
439601,440570,969,-1,2,chrXIV,known_gene
438566,439283,717,-1,2,chrXIV,known_gene
416939,417302,363,-1,2,chrXIV,known_gene
368594,370055,1461,-1,2,chrXIV,known_gene
360923,365717,4794,-1,2,chrXIV,known_gene
347765,348521,756,-1,2,chrXIV,known_gene
345668,346058,390,-1,2,chrXIV,known_gene
343646,344141,495,-1,2,chrXIV,known_gene
338477,339347,870,-1,2,chrXIV,known_gene
319415,321359,1944,-1,2,chrXIV,known_gene
318029,318809,780,-1,2,chrXIV,known_gene
314249,314561,312,-1,2,chrXIV,novel_orf
313862,314168,306,-1,2,chrXIV,novel_orf
307400,308612,1212,-1,2,chrXIV,known_gene
305069,306980,1911,-1,2,chrXIV,known_gene
300665,301103,438,-1,2,chrXIV,known_gene
294425,294782,357,-1,2,chrXIV,known_gene
292556,292883,327,-1,2,chrXIV,known_gene
281003,281303,300,-1,2,chrXIV,novel_orf
266513,266816,303,-1,2,chrXIV,known_gene
258374,259277,903,-1,2,chrXIV,known_gene
256787,258155,1368,-1,2,chrXIV,known_gene
242561,242867,306,-1,2,chrXIV,novel_orf
224795,227099,2304,-1,2,chrXIV,known_gene
220658,222431,1773,-1,2,chrXIV,known_gene
187169,187496,327,-1,2,chrXIV,known_gene
179393,181022,1629,-1,2,chrXIV,known_gene
171440,172286,846,-1,2,chrXIV,known_gene
158108,160373,2265,-1,2,chrXIV,known_gene
145562,146615,1053,-1,2,chrXIV,known_gene
129521,135383,5862,-1,2,chrXIV,known_gene
118430,118826,396,-1,2,chrXIV,known_gene
109094,110411,1317,-1,2,chrXIV,known_gene
103133,104102,969,-1,2,chrXIV,known_gene
98849,99161,312,-1,2,chrXIV,novel_orf
71672,76583,4911,-1,2,chrXIV,known_gene
33293,34235,942,-1,2,chrXIV,known_gene
6174,8115,1941,1,0,chrXV,known_gene
25272,26976,1704,1,0,chrXV,known_gene
44937,45633,696,1,0,chrXV,known_gene
53097,54552,1455,1,0,chrXV,known_gene
55557,56280,723,1,0,chrXV,known_gene
56451,58539,2088,1,0,chrXV,known_gene
58758,60030,1272,1,0,chrXV,known_gene
77559,78114,555,1,0,chrXV,known_gene
87843,89448,1605,1,0,chrXV,known_gene
104325,106293,1968,1,0,chrXV,known_gene
112101,113130,1029,1,0,chrXV,known_gene
115005,115356,351,1,0,chrXV,novel_orf
117999,119322,1323,1,0,chrXV,novel_orf
147381,150276,2895,1,0,chrXV,known_gene
168726,169974,1248,1,0,chrXV,known_gene
171069,180309,9240,1,0,chrXV,known_gene
181056,181455,399,1,0,chrXV,known_gene
187023,189414,2391,1,0,chrXV,known_gene
196506,196995,489,1,0,chrXV,known_gene
217125,218448,1323,1,0,chrXV,known_gene
219210,220473,1263,1,0,chrXV,known_gene
234939,238185,3246,1,0,chrXV,known_gene
247149,248301,1152,1,0,chrXV,known_gene
255336,256101,765,1,0,chrXV,known_gene
265428,266169,741,1,0,chrXV,known_gene
274956,276939,1983,1,0,chrXV,known_gene
278055,280086,2031,1,0,chrXV,known_gene
288897,290553,1656,1,0,chrXV,known_gene
310311,310935,624,1,0,chrXV,known_gene
325248,326130,882,1,0,chrXV,known_gene
333591,334356,765,1,0,chrXV,known_gene
344334,345798,1464,1,0,chrXV,known_gene
364368,366882,2514,1,0,chrXV,known_gene
400347,401214,867,1,0,chrXV,known_gene
428928,429240,312,1,0,chrXV,novel_orf
429477,429912,435,1,0,chrXV,known_gene
447438,448368,930,1,0,chrXV,known_gene
479532,480420,888,1,0,chrXV,known_gene
495126,496968,1842,1,0,chrXV,known_gene
502794,503346,552,1,0,chrXV,known_gene
511824,513006,1182,1,0,chrXV,known_gene
517641,518490,849,1,0,chrXV,known_gene
519120,519972,852,1,0,chrXV,known_gene
521352,522282,930,1,0,chrXV,known_gene
523026,524841,1815,1,0,chrXV,known_gene
531507,533793,2286,1,0,chrXV,known_gene
545028,546333,1305,1,0,chrXV,known_gene
573174,574830,1656,1,0,chrXV,known_gene
575097,577626,2529,1,0,chrXV,known_gene
586980,589281,2301,1,0,chrXV,known_gene
606513,608475,1962,1,0,chrXV,known_gene
619839,624375,4536,1,0,chrXV,known_gene
632163,633120,957,1,0,chrXV,known_gene
644565,646896,2331,1,0,chrXV,known_gene
649302,651732,2430,1,0,chrXV,known_gene
658746,659601,855,1,0,chrXV,known_gene
662400,663582,1182,1,0,chrXV,known_gene
674778,675150,372,1,0,chrXV,novel_orf
679356,680544,1188,1,0,chrXV,known_gene
710445,711576,1131,1,0,chrXV,known_gene
718782,719160,378,1,0,chrXV,novel_orf
720180,720510,330,1,0,chrXV,known_gene
722910,724725,1815,1,0,chrXV,known_gene
740706,741180,474,1,0,chrXV,novel_orf
747861,748209,348,1,0,chrXV,novel_orf
748275,748644,369,1,0,chrXV,novel_orf
752589,752895,306,1,0,chrXV,novel_orf
761391,761721,330,1,0,chrXV,known_gene
768408,769812,1404,1,0,chrXV,known_gene
770799,772113,1314,1,0,chrXV,known_gene
775845,778248,2403,1,0,chrXV,known_gene
785169,785655,486,1,0,chrXV,known_gene
785655,786744,1089,1,0,chrXV,known_gene
795105,795405,300,1,0,chrXV,novel_orf
798012,798315,303,1,0,chrXV,known_gene
807270,808107,837,1,0,chrXV,known_gene
818865,820158,1293,1,0,chrXV,known_gene
821022,822294,1272,1,0,chrXV,known_gene
832812,834195,1383,1,0,chrXV,known_gene
841332,841818,486,1,0,chrXV,known_gene
846999,847320,321,1,0,chrXV,known_gene
847452,848145,693,1,0,chrXV,known_gene
853356,854112,756,1,0,chrXV,known_gene
855801,856185,384,1,0,chrXV,novel_orf
861174,865593,4419,1,0,chrXV,known_gene
867399,867852,453,1,0,chrXV,known_gene
870201,874071,3870,1,0,chrXV,known_gene
875598,877038,1440,1,0,chrXV,known_gene
895308,895953,645,1,0,chrXV,novel_orf
903042,903372,330,1,0,chrXV,known_gene
909342,911445,2103,1,0,chrXV,known_gene
916029,918291,2262,1,0,chrXV,known_gene
923763,924156,393,1,0,chrXV,novel_orf
924576,925050,474,1,0,chrXV,known_gene
943107,943458,351,1,0,chrXV,novel_orf
944595,946008,1413,1,0,chrXV,known_gene
971850,975891,4041,1,0,chrXV,novel_orf
997212,998244,1032,1,0,chrXV,known_gene
1007220,1009116,1896,1,0,chrXV,known_gene
1010160,1010889,729,1,0,chrXV,known_gene
1012002,1012392,390,1,0,chrXV,known_gene
1026006,1026609,603,1,0,chrXV,known_gene
1036833,1039389,2556,1,0,chrXV,known_gene
1039839,1041399,1560,1,0,chrXV,known_gene
1043190,1043559,369,1,0,chrXV,known_gene
1055544,1057680,2136,1,0,chrXV,known_gene
1065042,1065915,873,1,0,chrXV,known_gene
1085472,1090863,5391,1,0,chrXV,known_gene
34657,35407,750,1,1,chrXV,known_gene
40747,42610,1863,1,1,chrXV,known_gene
43693,44722,1029,1,1,chrXV,known_gene
49894,50260,366,1,1,chrXV,novel_orf
65620,67114,1494,1,1,chrXV,known_gene
70324,70690,366,1,1,chrXV,known_gene
71299,72715,1416,1,1,chrXV,known_gene
73030,73357,327,1,1,chrXV,known_gene
83833,85264,1431,1,1,chrXV,known_gene
90730,91102,372,1,1,chrXV,novel_orf
99808,100957,1149,1,1,chrXV,known_gene
104587,104920,333,1,1,chrXV,known_gene
110296,110638,342,1,1,chrXV,known_gene
119800,123268,3468,1,1,chrXV,novel_orf
123991,125830,1839,1,1,chrXV,known_gene
145333,147163,1830,1,1,chrXV,known_gene
162355,165331,2976,1,1,chrXV,known_gene
181681,185212,3531,1,1,chrXV,known_gene
223267,224179,912,1,1,chrXV,known_gene
225016,225325,309,1,1,chrXV,novel_orf
228613,229834,1221,1,1,chrXV,known_gene
236107,236452,345,1,1,chrXV,known_gene
238618,240094,1476,1,1,chrXV,known_gene
243496,246802,3306,1,1,chrXV,known_gene
254296,254617,321,1,1,chrXV,known_gene
256744,259030,2286,1,1,chrXV,known_gene
268186,269641,1455,1,1,chrXV,known_gene
270799,271147,348,1,1,chrXV,novel_orf
286171,287950,1779,1,1,chrXV,known_gene
292528,294673,2145,1,1,chrXV,known_gene
299692,300067,375,1,1,chrXV,known_gene
329416,331051,1635,1,1,chrXV,known_gene
346321,346726,405,1,1,chrXV,novel_orf
349678,353863,4185,1,1,chrXV,known_gene
356542,356956,414,1,1,chrXV,known_gene
357673,359947,2274,1,1,chrXV,known_gene
359992,360352,360,1,1,chrXV,known_gene
361411,363814,2403,1,1,chrXV,known_gene
379780,380806,1026,1,1,chrXV,known_gene
381052,382822,1770,1,1,chrXV,known_gene
386824,388684,1860,1,1,chrXV,known_gene
398869,399226,357,1,1,chrXV,novel_orf
399253,399694,441,1,1,chrXV,novel_orf
401440,402655,1215,1,1,chrXV,known_gene
408424,409660,1236,1,1,chrXV,known_gene
410869,412330,1461,1,1,chrXV,known_gene
416761,417088,327,1,1,chrXV,novel_orf
420553,420880,327,1,1,chrXV,novel_orf
427816,428158,342,1,1,chrXV,known_gene
444685,445849,1164,1,1,chrXV,known_gene
447658,447976,318,1,1,chrXV,known_gene
464770,466543,1773,1,1,chrXV,known_gene
468211,469252,1041,1,1,chrXV,known_gene
471898,472597,699,1,1,chrXV,known_gene
480586,481750,1164,1,1,chrXV,known_gene
482032,483085,1053,1,1,chrXV,known_gene
493264,494470,1206,1,1,chrXV,known_gene
518194,518521,327,1,1,chrXV,known_gene
525277,528601,3324,1,1,chrXV,known_gene
528940,530248,1308,1,1,chrXV,known_gene
530428,531127,699,1,1,chrXV,known_gene
546856,548560,1704,1,1,chrXV,known_gene
551113,552052,939,1,1,chrXV,known_gene
561169,564193,3024,1,1,chrXV,known_gene
578563,579793,1230,1,1,chrXV,known_gene
580249,581359,1110,1,1,chrXV,known_gene
593056,594046,990,1,1,chrXV,known_gene
595111,596434,1323,1,1,chrXV,novel_orf
605452,605824,372,1,1,chrXV,novel_orf
605872,606178,306,1,1,chrXV,known_gene
611998,612490,492,1,1,chrXV,known_gene
633838,636757,2919,1,1,chrXV,known_gene
671875,672322,447,1,1,chrXV,novel_orf
678871,679261,390,1,1,chrXV,known_gene
683110,683545,435,1,1,chrXV,known_gene
689623,689974,351,1,1,chrXV,known_gene
690694,692032,1338,1,1,chrXV,known_gene
717022,718384,1362,1,1,chrXV,known_gene
721945,722608,663,1,1,chrXV,known_gene
733924,736177,2253,1,1,chrXV,known_gene
742909,744181,1272,1,1,chrXV,known_gene
758329,759253,924,1,1,chrXV,known_gene
759781,760660,879,1,1,chrXV,known_gene
772600,774127,1527,1,1,chrXV,known_gene
779869,780184,315,1,1,chrXV,known_gene
781993,783298,1305,1,1,chrXV,known_gene
783667,784588,921,1,1,chrXV,known_gene
786994,788641,1647,1,1,chrXV,known_gene
804376,804907,531,1,1,chrXV,known_gene
812875,813331,456,1,1,chrXV,novel_orf
817291,818335,1044,1,1,chrXV,known_gene
820453,820774,321,1,1,chrXV,known_gene
826384,827869,1485,1,1,chrXV,known_gene
837673,838960,1287,1,1,chrXV,known_gene
849634,850054,420,1,1,chrXV,known_gene
850279,850729,450,1,1,chrXV,known_gene
868339,868951,612,1,1,chrXV,known_gene
878434,880675,2241,1,1,chrXV,known_gene
882898,884134,1236,1,1,chrXV,known_gene
889021,889750,729,1,1,chrXV,known_gene
904759,905800,1041,1,1,chrXV,known_gene
922408,922807,399,1,1,chrXV,novel_orf
925720,930445,4725,1,1,chrXV,known_gene
937291,937786,495,1,1,chrXV,novel_orf
954343,956623,2280,1,1,chrXV,known_gene
987283,987592,309,1,1,chrXV,novel_orf
989788,992833,3045,1,1,chrXV,known_gene
1005136,1006705,1569,1,1,chrXV,known_gene
1016722,1017043,321,1,1,chrXV,novel_orf
1023370,1023739,369,1,1,chrXV,known_gene
1028215,1028515,300,1,1,chrXV,novel_orf
1037323,1037704,381,1,1,chrXV,known_gene
1061563,1063648,2085,1,1,chrXV,known_gene
1079281,1079725,444,1,1,chrXV,known_gene
1089199,1089775,576,1,1,chrXV,known_gene
9596,10106,510,1,2,chrXV,known_gene
10118,10766,648,1,2,chrXV,known_gene
14312,14654,342,1,2,chrXV,known_gene
31166,31532,366,1,2,chrXV,novel_orf
48737,49448,711,1,2,chrXV,known_gene
63155,63668,513,1,2,chrXV,novel_orf
74399,76979,2580,1,2,chrXV,known_gene
97550,99488,1938,1,2,chrXV,known_gene
101474,103229,1755,1,2,chrXV,known_gene
106709,108188,1479,1,2,chrXV,known_gene
109175,109889,714,1,2,chrXV,known_gene
113225,113579,354,1,2,chrXV,known_gene
128048,128348,300,1,2,chrXV,novel_orf
129236,132482,3246,1,2,chrXV,known_gene
134165,134621,456,1,2,chrXV,novel_orf
142814,143696,882,1,2,chrXV,known_gene
144203,145130,927,1,2,chrXV,known_gene
162749,163070,321,1,2,chrXV,known_gene
165713,166952,1239,1,2,chrXV,known_gene
194969,196337,1368,1,2,chrXV,known_gene
198941,200297,1356,1,2,chrXV,known_gene
212243,213734,1491,1,2,chrXV,known_gene
220766,222902,2136,1,2,chrXV,known_gene
230084,231272,1188,1,2,chrXV,known_gene
249824,250916,1092,1,2,chrXV,known_gene
253121,253589,468,1,2,chrXV,novel_orf
259922,263204,3282,1,2,chrXV,known_gene
263474,265085,1611,1,2,chrXV,known_gene
266636,267026,390,1,2,chrXV,novel_orf
269159,269519,360,1,2,chrXV,known_gene
277085,277604,519,1,2,chrXV,known_gene
297077,298838,1761,1,2,chrXV,known_gene
305348,307409,2061,1,2,chrXV,known_gene
307937,309041,1104,1,2,chrXV,known_gene
316937,321548,4611,1,2,chrXV,known_gene
326831,329033,2202,1,2,chrXV,known_gene
331454,332891,1437,1,2,chrXV,known_gene
356750,357221,471,1,2,chrXV,known_gene
368126,370319,2193,1,2,chrXV,known_gene
377846,378170,324,1,2,chrXV,known_gene
378218,379562,1344,1,2,chrXV,known_gene
384599,384935,336,1,2,chrXV,known_gene
405767,406544,777,1,2,chrXV,known_gene
407063,407921,858,1,2,chrXV,known_gene
413006,413480,474,1,2,chrXV,known_gene
432185,433373,1188,1,2,chrXV,known_gene
441533,442553,1020,1,2,chrXV,known_gene
449435,451325,1890,1,2,chrXV,known_gene
453767,455795,2028,1,2,chrXV,known_gene
461501,461816,315,1,2,chrXV,known_gene
472724,473369,645,1,2,chrXV,known_gene
474551,476792,2241,1,2,chrXV,known_gene
487706,489734,2028,1,2,chrXV,known_gene
503615,503948,333,1,2,chrXV,novel_orf
515243,516173,930,1,2,chrXV,known_gene
516422,516773,351,1,2,chrXV,known_gene
534074,536819,2745,1,2,chrXV,known_gene
537569,538454,885,1,2,chrXV,known_gene
596912,600380,3468,1,2,chrXV,novel_orf
624728,626492,1764,1,2,chrXV,known_gene
642740,643307,567,1,2,chrXV,known_gene
651857,652163,306,1,2,chrXV,known_gene
654209,656570,2361,1,2,chrXV,known_gene
657131,658325,1194,1,2,chrXV,known_gene
675938,677840,1902,1,2,chrXV,known_gene
684029,685343,1314,1,2,chrXV,known_gene
685766,689180,3414,1,2,chrXV,known_gene
692474,697334,4860,1,2,chrXV,known_gene
712031,712370,339,1,2,chrXV,novel_orf
712865,715331,2466,1,2,chrXV,known_gene
720416,720815,399,1,2,chrXV,known_gene
722564,722918,354,1,2,chrXV,known_gene
727511,729644,2133,1,2,chrXV,known_gene
749300,751886,2586,1,2,chrXV,known_gene
755327,756125,798,1,2,chrXV,known_gene
756863,757250,387,1,2,chrXV,novel_orf
762824,766565,3741,1,2,chrXV,known_gene
774572,775259,687,1,2,chrXV,known_gene
780905,781541,636,1,2,chrXV,known_gene
784856,785696,840,1,2,chrXV,known_gene
792530,793868,1338,1,2,chrXV,known_gene
797675,798308,633,1,2,chrXV,known_gene
803666,804203,537,1,2,chrXV,known_gene
811007,811493,486,1,2,chrXV,known_gene
811670,812324,654,1,2,chrXV,known_gene
813983,815720,1737,1,2,chrXV,known_gene
822821,823211,390,1,2,chrXV,novel_orf
831299,831599,300,1,2,chrXV,novel_orf
835634,835958,324,1,2,chrXV,novel_orf
842816,843644,828,1,2,chrXV,known_gene
843803,844220,417,1,2,chrXV,novel_orf
848477,849209,732,1,2,chrXV,known_gene
869207,869894,687,1,2,chrXV,known_gene
880574,880883,309,1,2,chrXV,known_gene
880964,882272,1308,1,2,chrXV,known_gene
884513,887876,3363,1,2,chrXV,known_gene
912821,913463,642,1,2,chrXV,known_gene
931802,936497,4695,1,2,chrXV,known_gene
943655,944357,702,1,2,chrXV,known_gene
949772,953870,4098,1,2,chrXV,known_gene
956897,957989,1092,1,2,chrXV,known_gene
960986,965981,4995,1,2,chrXV,known_gene
970577,971894,1317,1,2,chrXV,novel_orf
981827,984785,2958,1,2,chrXV,known_gene
1011188,1012760,1572,1,2,chrXV,known_gene
1025255,1025609,354,1,2,chrXV,known_gene
1026842,1028048,1206,1,2,chrXV,known_gene
1046225,1047803,1578,1,2,chrXV,known_gene
1049510,1051058,1548,1,2,chrXV,known_gene
1051289,1052930,1641,1,2,chrXV,known_gene
1059530,1059992,462,1,2,chrXV,known_gene
1066838,1068536,1698,1,2,chrXV,known_gene
1074212,1076087,1875,1,2,chrXV,known_gene
1076783,1077911,1128,1,2,chrXV,known_gene
1080275,1081589,1314,1,2,chrXV,known_gene
1082717,1083212,495,1,2,chrXV,known_gene
1089221,1089728,507,-1,0,chrXV,novel_orf
1088516,1088852,336,-1,0,chrXV,novel_orf
1078544,1079258,714,-1,0,chrXV,known_gene
1060475,1060961,486,-1,0,chrXV,known_gene
1050725,1051064,339,-1,0,chrXV,known_gene
1041677,1043042,1365,-1,0,chrXV,known_gene
1040363,1040666,303,-1,0,chrXV,novel_orf
1037126,1037453,327,-1,0,chrXV,novel_orf
1029182,1030994,1812,-1,0,chrXV,known_gene
1020221,1023212,2991,-1,0,chrXV,known_gene
1013240,1014821,1581,-1,0,chrXV,known_gene
1009223,1009712,489,-1,0,chrXV,known_gene
984941,986462,1521,-1,0,chrXV,known_gene
973769,974084,315,-1,0,chrXV,novel_orf
968147,968474,327,-1,0,chrXV,known_gene
966665,967625,960,-1,0,chrXV,known_gene
965411,965729,318,-1,0,chrXV,novel_orf
959201,960182,981,-1,0,chrXV,known_gene
958361,958832,471,-1,0,chrXV,known_gene
946232,949109,2877,-1,0,chrXV,known_gene
944540,944957,417,-1,0,chrXV,known_gene
939620,943463,3843,-1,0,chrXV,known_gene
923231,925040,1809,-1,0,chrXV,known_gene
918605,921062,2457,-1,0,chrXV,known_gene
917489,917855,366,-1,0,chrXV,novel_orf
894623,896387,1764,-1,0,chrXV,known_gene
892730,894092,1362,-1,0,chrXV,known_gene
877229,877685,456,-1,0,chrXV,known_gene
874742,875321,579,-1,0,chrXV,known_gene
865652,866582,930,-1,0,chrXV,known_gene
863312,863696,384,-1,0,chrXV,novel_orf
862820,863210,390,-1,0,chrXV,novel_orf
855146,860258,5112,-1,0,chrXV,known_gene
844991,845792,801,-1,0,chrXV,known_gene
841514,841823,309,-1,0,chrXV,known_gene
825533,825932,399,-1,0,chrXV,known_gene
822587,824867,2280,-1,0,chrXV,known_gene
818756,819164,408,-1,0,chrXV,known_gene
808253,810683,2430,-1,0,chrXV,known_gene
805031,807023,1992,-1,0,chrXV,known_gene
800969,802307,1338,-1,0,chrXV,known_gene
795800,796793,993,-1,0,chrXV,known_gene
794075,795332,1257,-1,0,chrXV,known_gene
788741,789857,1116,-1,0,chrXV,known_gene
766868,767777,909,-1,0,chrXV,known_gene
752213,755009,2796,-1,0,chrXV,known_gene
751475,751895,420,-1,0,chrXV,known_gene
747524,748979,1455,-1,0,chrXV,known_gene
745592,746303,711,-1,0,chrXV,known_gene
738923,741632,2709,-1,0,chrXV,known_gene
736436,737726,1290,-1,0,chrXV,known_gene
730007,733457,3450,-1,0,chrXV,known_gene
718652,720065,1413,-1,0,chrXV,known_gene
715592,716837,1245,-1,0,chrXV,known_gene
681443,682106,663,-1,0,chrXV,known_gene
674351,675167,816,-1,0,chrXV,known_gene
667859,670241,2382,-1,0,chrXV,known_gene
636938,638558,1620,-1,0,chrXV,known_gene
630965,631751,786,-1,0,chrXV,known_gene
626627,627980,1353,-1,0,chrXV,known_gene
608639,609197,558,-1,0,chrXV,known_gene
601382,602342,960,-1,0,chrXV,known_gene
586949,587342,393,-1,0,chrXV,known_gene
566876,569558,2682,-1,0,chrXV,known_gene
553175,554570,1395,-1,0,chrXV,known_gene
545117,545420,303,-1,0,chrXV,novel_orf
539762,544145,4383,-1,0,chrXV,known_gene
538658,539465,807,-1,0,chrXV,known_gene
532250,532865,615,-1,0,chrXV,novel_orf
507947,511178,3231,-1,0,chrXV,known_gene
496148,496541,393,-1,0,chrXV,novel_orf
483218,486779,3561,-1,0,chrXV,known_gene
473474,474416,942,-1,0,chrXV,known_gene
469376,471620,2244,-1,0,chrXV,known_gene
459479,461276,1797,-1,0,chrXV,known_gene
455906,457820,1914,-1,0,chrXV,known_gene
446078,446738,660,-1,0,chrXV,known_gene
442724,443531,807,-1,0,chrXV,known_gene
438905,440258,1353,-1,0,chrXV,known_gene
427832,429857,2025,-1,0,chrXV,known_gene
414458,415907,1449,-1,0,chrXV,known_gene
392576,392915,339,-1,0,chrXV,known_gene
373709,375857,2148,-1,0,chrXV,known_gene
372797,373439,642,-1,0,chrXV,known_gene
370523,370844,321,-1,0,chrXV,known_gene
337679,338621,942,-1,0,chrXV,known_gene
334508,337343,2835,-1,0,chrXV,known_gene
321857,322994,1137,-1,0,chrXV,known_gene
315812,316175,363,-1,0,chrXV,known_gene
309323,310139,816,-1,0,chrXV,known_gene
303578,303983,405,-1,0,chrXV,known_gene
301379,303035,1656,-1,0,chrXV,known_gene
294776,296120,1344,-1,0,chrXV,known_gene
280271,281498,1227,-1,0,chrXV,known_gene
270632,271370,738,-1,0,chrXV,known_gene
253148,253577,429,-1,0,chrXV,known_gene
241613,242267,654,-1,0,chrXV,known_gene
240203,240524,321,-1,0,chrXV,known_gene
237881,238202,321,-1,0,chrXV,known_gene
232445,233636,1191,-1,0,chrXV,known_gene
217307,217646,339,-1,0,chrXV,novel_orf
214016,216137,2121,-1,0,chrXV,known_gene
206102,207176,1074,-1,0,chrXV,known_gene
197219,198725,1506,-1,0,chrXV,known_gene
180557,181427,870,-1,0,chrXV,known_gene
169001,169319,318,-1,0,chrXV,novel_orf
161672,162014,342,-1,0,chrXV,known_gene
153911,154745,834,-1,0,chrXV,known_gene
139226,141347,2121,-1,0,chrXV,known_gene
136526,137825,1299,-1,0,chrXV,known_gene
125996,126689,693,-1,0,chrXV,known_gene
114137,115808,1671,-1,0,chrXV,known_gene
108257,108896,639,-1,0,chrXV,known_gene
103316,103925,609,-1,0,chrXV,known_gene
57776,58112,336,-1,0,chrXV,novel_orf
55805,56120,315,-1,0,chrXV,novel_orf
38174,38567,393,-1,0,chrXV,novel_orf
37271,38066,795,-1,0,chrXV,novel_orf
36821,37154,333,-1,0,chrXV,novel_orf
19490,21311,1821,-1,0,chrXV,known_gene
1646,2078,432,-1,0,chrXV,known_gene
1034806,1036471,1665,-1,1,chrXV,known_gene
1031488,1034182,2694,-1,1,chrXV,known_gene
1023460,1025572,2112,-1,1,chrXV,known_gene
1015360,1017652,2292,-1,1,chrXV,known_gene
1001146,1003225,2079,-1,1,chrXV,known_gene
998452,1000828,2376,-1,1,chrXV,known_gene
995017,996511,1494,-1,1,chrXV,known_gene
992863,994855,1992,-1,1,chrXV,known_gene
981811,982162,351,-1,1,chrXV,known_gene
964612,964936,324,-1,1,chrXV,novel_orf
943564,944122,558,-1,1,chrXV,known_gene
936730,939349,2619,-1,1,chrXV,known_gene
930733,931081,348,-1,1,chrXV,known_gene
925978,926302,324,-1,1,chrXV,novel_orf
913618,915094,1476,-1,1,chrXV,known_gene
906235,907555,1320,-1,1,chrXV,known_gene
896824,898360,1536,-1,1,chrXV,known_gene
850936,851839,903,-1,1,chrXV,known_gene
846268,847129,861,-1,1,chrXV,known_gene
843697,844630,933,-1,1,chrXV,known_gene
839083,841069,1986,-1,1,chrXV,known_gene
834451,836431,1980,-1,1,chrXV,known_gene
831058,832042,984,-1,1,chrXV,known_gene
822751,823189,438,-1,1,chrXV,known_gene
815914,816931,1017,-1,1,chrXV,known_gene
802549,803464,915,-1,1,chrXV,known_gene
798673,800731,2058,-1,1,chrXV,known_gene
792703,793042,339,-1,1,chrXV,novel_orf
790210,792241,2031,-1,1,chrXV,known_gene
765898,766324,426,-1,1,chrXV,novel_orf
756475,757558,1083,-1,1,chrXV,known_gene
750532,751000,468,-1,1,chrXV,novel_orf
749662,749962,300,-1,1,chrXV,novel_orf
725563,727234,1671,-1,1,chrXV,known_gene
720469,721708,1239,-1,1,chrXV,known_gene
713242,713584,342,-1,1,chrXV,novel_orf
711682,712543,861,-1,1,chrXV,known_gene
708415,709852,1437,-1,1,chrXV,novel_orf
698767,700567,1800,-1,1,chrXV,known_gene
693367,693703,336,-1,1,chrXV,novel_orf
652009,653884,1875,-1,1,chrXV,known_gene
647125,648502,1377,-1,1,chrXV,known_gene
643393,644332,939,-1,1,chrXV,known_gene
639559,641992,2433,-1,1,chrXV,known_gene
602716,605092,2376,-1,1,chrXV,known_gene
584308,586324,2016,-1,1,chrXV,known_gene
581812,583681,1869,-1,1,chrXV,known_gene
564475,566191,1716,-1,1,chrXV,known_gene
559960,560677,717,-1,1,chrXV,known_gene
551797,552103,306,-1,1,chrXV,known_gene
548791,550246,1455,-1,1,chrXV,known_gene
536281,536599,318,-1,1,chrXV,novel_orf
516448,516850,402,-1,1,chrXV,known_gene
508972,509314,342,-1,1,chrXV,known_gene
506977,507505,528,-1,1,chrXV,known_gene
503551,504328,777,-1,1,chrXV,known_gene
491122,492841,1719,-1,1,chrXV,known_gene
490195,490828,633,-1,1,chrXV,known_gene
489415,489715,300,-1,1,chrXV,novel_orf
476938,479188,2250,-1,1,chrXV,known_gene
453868,454213,345,-1,1,chrXV,known_gene
445420,445816,396,-1,1,chrXV,novel_orf
444811,445279,468,-1,1,chrXV,novel_orf
440389,441163,774,-1,1,chrXV,known_gene
433687,436345,2658,-1,1,chrXV,known_gene
430246,431626,1380,-1,1,chrXV,known_gene
427828,428137,309,-1,1,chrXV,known_gene
402760,405388,2628,-1,1,chrXV,known_gene
389770,391075,1305,-1,1,chrXV,known_gene
369727,370027,300,-1,1,chrXV,novel_orf
360460,361084,624,-1,1,chrXV,known_gene
323410,324394,984,-1,1,chrXV,known_gene
311341,312367,1026,-1,1,chrXV,known_gene
308308,308611,303,-1,1,chrXV,novel_orf
272002,273724,1722,-1,1,chrXV,known_gene
266263,267529,1266,-1,1,chrXV,known_gene
264178,264676,498,-1,1,chrXV,novel_orf
258802,259105,303,-1,1,chrXV,known_gene
251266,252646,1380,-1,1,chrXV,known_gene
224419,226075,1656,-1,1,chrXV,known_gene
214024,214495,471,-1,1,chrXV,known_gene
207391,210265,2874,-1,1,chrXV,known_gene
204730,205885,1155,-1,1,chrXV,known_gene
199831,200134,303,-1,1,chrXV,novel_orf
193831,194800,969,-1,1,chrXV,known_gene
166288,166612,324,-1,1,chrXV,known_gene
159547,160594,1047,-1,1,chrXV,known_gene
150397,153490,3093,-1,1,chrXV,known_gene
141583,142555,972,-1,1,chrXV,known_gene
138106,139057,951,-1,1,chrXV,known_gene
132724,135838,3114,-1,1,chrXV,known_gene
132016,132508,492,-1,1,chrXV,known_gene
116395,117454,1059,-1,1,chrXV,known_gene
111430,111886,456,-1,1,chrXV,known_gene
96607,96916,309,-1,1,chrXV,known_gene
94855,96361,1506,-1,1,chrXV,known_gene
61324,65350,4026,-1,1,chrXV,known_gene
60382,61024,642,-1,1,chrXV,known_gene
47932,48643,711,-1,1,chrXV,known_gene
34765,35077,312,-1,1,chrXV,novel_orf
28702,31606,2904,-1,1,chrXV,known_gene
11548,11911,363,-1,1,chrXV,known_gene
1090014,1090497,483,-1,2,chrXV,known_gene
1089138,1089714,576,-1,2,chrXV,novel_orf
1086630,1086981,351,-1,2,chrXV,novel_orf
1071792,1072923,1131,-1,2,chrXV,known_gene
1069620,1070241,621,-1,2,chrXV,known_gene
1060440,1061055,615,-1,2,chrXV,known_gene
1055772,1056099,327,-1,2,chrXV,novel_orf
1040277,1040613,336,-1,2,chrXV,novel_orf
1028193,1028625,432,-1,2,chrXV,known_gene
1017879,1018746,867,-1,2,chrXV,known_gene
986898,988782,1884,-1,2,chrXV,known_gene
977193,978069,876,-1,2,chrXV,known_gene
921534,922905,1371,-1,2,chrXV,known_gene
901857,902874,1017,-1,2,chrXV,known_gene
900249,900690,441,-1,2,chrXV,known_gene
899055,899928,873,-1,2,chrXV,known_gene
896697,897078,381,-1,2,chrXV,known_gene
889866,891432,1566,-1,2,chrXV,known_gene
879861,880515,654,-1,2,chrXV,novel_orf
852120,853077,957,-1,2,chrXV,known_gene
828051,830574,2523,-1,2,chrXV,known_gene
827421,827862,441,-1,2,chrXV,novel_orf
812394,813708,1314,-1,2,chrXV,known_gene
761613,762084,471,-1,2,chrXV,known_gene
760824,761265,441,-1,2,chrXV,known_gene
746724,747282,558,-1,2,chrXV,known_gene
744534,745281,747,-1,2,chrXV,known_gene
704418,708459,4041,-1,2,chrXV,novel_orf
671844,672411,567,-1,2,chrXV,known_gene
665784,667179,1395,-1,2,chrXV,known_gene
659814,661674,1860,-1,2,chrXV,known_gene
651375,651840,465,-1,2,chrXV,known_gene
633924,634296,372,-1,2,chrXV,novel_orf
628359,630540,2181,-1,2,chrXV,known_gene
617517,618288,771,-1,2,chrXV,known_gene
612996,616671,3675,-1,2,chrXV,known_gene
609837,611388,1551,-1,2,chrXV,known_gene
605346,606171,825,-1,2,chrXV,known_gene
589941,592587,2646,-1,2,chrXV,known_gene
587616,587943,327,-1,2,chrXV,novel_orf
580158,580500,342,-1,2,chrXV,known_gene
572181,572838,657,-1,2,chrXV,known_gene
569928,570807,879,-1,2,chrXV,known_gene
559029,559848,819,-1,2,chrXV,known_gene
554823,558642,3819,-1,2,chrXV,known_gene
513294,514278,984,-1,2,chrXV,known_gene
497505,502452,4947,-1,2,chrXV,known_gene
493419,494400,981,-1,2,chrXV,novel_orf
482310,482724,414,-1,2,chrXV,novel_orf
479295,479637,342,-1,2,chrXV,known_gene
466674,467589,915,-1,2,chrXV,known_gene
451728,453462,1734,-1,2,chrXV,known_gene
426771,427224,453,-1,2,chrXV,known_gene
424845,426084,1239,-1,2,chrXV,known_gene
424269,424617,348,-1,2,chrXV,known_gene
422667,423816,1149,-1,2,chrXV,known_gene
418629,421650,3021,-1,2,chrXV,known_gene
416346,417681,1335,-1,2,chrXV,known_gene
411825,412263,438,-1,2,chrXV,novel_orf
408357,408789,432,-1,2,chrXV,known_gene
397734,400104,2370,-1,2,chrXV,known_gene
394836,397086,2250,-1,2,chrXV,known_gene
392415,394524,2109,-1,2,chrXV,known_gene
388212,388533,321,-1,2,chrXV,novel_orf
383532,384420,888,-1,2,chrXV,known_gene
376011,377712,1701,-1,2,chrXV,known_gene
346194,346950,756,-1,2,chrXV,known_gene
341277,342414,1137,-1,2,chrXV,known_gene
338937,339978,1041,-1,2,chrXV,known_gene
313077,315387,2310,-1,2,chrXV,known_gene
290880,292074,1194,-1,2,chrXV,known_gene
286776,287214,438,-1,2,chrXV,novel_orf
282420,285426,3006,-1,2,chrXV,known_gene
274011,274353,342,-1,2,chrXV,known_gene
269814,270420,606,-1,2,chrXV,known_gene
256665,257019,354,-1,2,chrXV,known_gene
248391,249534,1143,-1,2,chrXV,known_gene
245739,246072,333,-1,2,chrXV,novel_orf
243465,244140,675,-1,2,chrXV,known_gene
210519,211995,1476,-1,2,chrXV,known_gene
202695,204471,1776,-1,2,chrXV,known_gene
201984,202518,534,-1,2,chrXV,known_gene
200367,201879,1512,-1,2,chrXV,known_gene
189657,193542,3885,-1,2,chrXV,known_gene
185847,186723,876,-1,2,chrXV,known_gene
177402,177711,309,-1,2,chrXV,novel_orf
155286,158637,3351,-1,2,chrXV,known_gene
126981,127920,939,-1,2,chrXV,known_gene
125109,125409,300,-1,2,chrXV,novel_orf
110307,110628,321,-1,2,chrXV,novel_orf
92025,92328,303,-1,2,chrXV,known_gene
89691,91419,1728,-1,2,chrXV,known_gene
85455,86757,1302,-1,2,chrXV,known_gene
84474,84870,396,-1,2,chrXV,novel_orf
81786,83058,1272,-1,2,chrXV,known_gene
78351,79479,1128,-1,2,chrXV,known_gene
70155,70545,390,-1,2,chrXV,known_gene
69375,70044,669,-1,2,chrXV,known_gene
67560,68754,1194,-1,2,chrXV,known_gene
54594,55104,510,-1,2,chrXV,known_gene
49554,52788,3234,-1,2,chrXV,known_gene
45759,47574,1815,-1,2,chrXV,known_gene
44472,44784,312,-1,2,chrXV,known_gene
28977,29328,351,-1,2,chrXV,known_gene
22524,24294,1770,-1,2,chrXV,known_gene
17280,17796,516,-1,2,chrXV,known_gene
999,1338,339,-1,2,chrXV,known_gene
642,1125,483,1,0,chrXVI,known_gene
1425,2001,576,1,0,chrXVI,known_gene
4158,4509,351,1,0,chrXVI,novel_orf
11886,12600,714,1,0,chrXVI,known_gene
15435,15795,360,1,0,chrXVI,novel_orf
25086,26064,978,1,0,chrXVI,known_gene
33012,34947,1935,1,0,chrXVI,known_gene
35235,37845,2610,1,0,chrXVI,known_gene
39120,40077,957,1,0,chrXVI,known_gene
49302,50958,1656,1,0,chrXVI,known_gene
58548,62016,3468,1,0,chrXVI,novel_orf
99483,100086,603,1,0,chrXVI,known_gene
107274,108147,873,1,0,chrXVI,known_gene
108651,114315,5664,1,0,chrXVI,known_gene
115311,116487,1176,1,0,chrXVI,known_gene
117066,117687,621,1,0,chrXVI,known_gene
130161,132228,2067,1,0,chrXVI,known_gene
135789,136443,654,1,0,chrXVI,known_gene
136749,138228,1479,1,0,chrXVI,known_gene
141036,141726,690,1,0,chrXVI,novel_orf
143820,147129,3309,1,0,chrXVI,known_gene
148812,149121,309,1,0,chrXVI,novel_orf
171483,171954,471,1,0,chrXVI,known_gene
189153,190983,1830,1,0,chrXVI,known_gene
193647,194145,498,1,0,chrXVI,known_gene
195252,195648,396,1,0,chrXVI,known_gene
212157,212784,627,1,0,chrXVI,known_gene
231216,232509,1293,1,0,chrXVI,known_gene
280479,280926,447,1,0,chrXVI,known_gene
297552,298050,498,1,0,chrXVI,known_gene
303120,304014,894,1,0,chrXVI,known_gene
304386,305058,672,1,0,chrXVI,known_gene
310209,312900,2691,1,0,chrXVI,known_gene
351942,352251,309,1,0,chrXVI,novel_orf
353910,354273,363,1,0,chrXVI,novel_orf
370977,372921,1944,1,0,chrXVI,known_gene
375501,376953,1452,1,0,chrXVI,known_gene
383454,384408,954,1,0,chrXVI,known_gene
387066,393654,6588,1,0,chrXVI,known_gene
410442,411285,843,1,0,chrXVI,known_gene
412827,415362,2535,1,0,chrXVI,known_gene
427926,428655,729,1,0,chrXVI,known_gene
459072,459678,606,1,0,chrXVI,known_gene
464400,465648,1248,1,0,chrXVI,known_gene
467259,469656,2397,1,0,chrXVI,known_gene
469938,471996,2058,1,0,chrXVI,known_gene
480534,481068,534,1,0,chrXVI,known_gene
486711,487209,498,1,0,chrXVI,known_gene
493542,495246,1704,1,0,chrXVI,known_gene
517650,518760,1110,1,0,chrXVI,known_gene
521013,524958,3945,1,0,chrXVI,known_gene
529722,533409,3687,1,0,chrXVI,known_gene
535017,535587,570,1,0,chrXVI,known_gene
554604,555729,1125,1,0,chrXVI,known_gene
558384,559935,1551,1,0,chrXVI,known_gene
615378,619014,3636,1,0,chrXVI,known_gene
627879,631245,3366,1,0,chrXVI,known_gene
634122,637224,3102,1,0,chrXVI,known_gene
642207,643320,1113,1,0,chrXVI,known_gene
647304,648375,1071,1,0,chrXVI,known_gene
657513,658938,1425,1,0,chrXVI,known_gene
659181,661053,1872,1,0,chrXVI,known_gene
661743,662133,390,1,0,chrXVI,novel_orf
664959,665490,531,1,0,chrXVI,known_gene
666279,667446,1167,1,0,chrXVI,known_gene
679692,680799,1107,1,0,chrXVI,known_gene
698868,700014,1146,1,0,chrXVI,known_gene
700593,701970,1377,1,0,chrXVI,known_gene
702189,702675,486,1,0,chrXVI,novel_orf
703329,703674,345,1,0,chrXVI,novel_orf
704853,706593,1740,1,0,chrXVI,known_gene
706971,708342,1371,1,0,chrXVI,known_gene
710100,711138,1038,1,0,chrXVI,known_gene
713274,715941,2667,1,0,chrXVI,known_gene
720636,720960,324,1,0,chrXVI,known_gene
730491,731019,528,1,0,chrXVI,known_gene
732348,733212,864,1,0,chrXVI,known_gene
751392,751824,432,1,0,chrXVI,novel_orf
752256,752919,663,1,0,chrXVI,known_gene
753300,754248,948,1,0,chrXVI,known_gene
767751,768987,1236,1,0,chrXVI,known_gene
786207,787428,1221,1,0,chrXVI,known_gene
796575,796902,327,1,0,chrXVI,novel_orf
799233,802017,2784,1,0,chrXVI,known_gene
818322,819075,753,1,0,chrXVI,known_gene
829917,830439,522,1,0,chrXVI,known_gene
834564,835212,648,1,0,chrXVI,known_gene
843261,844020,759,1,0,chrXVI,known_gene
867135,867486,351,1,0,chrXVI,novel_orf
870702,874926,4224,1,0,chrXVI,known_gene
875367,875997,630,1,0,chrXVI,known_gene
883827,885558,1731,1,0,chrXVI,known_gene
885795,886398,603,1,0,chrXVI,known_gene
886917,887538,621,1,0,chrXVI,novel_orf
902043,906654,4611,1,0,chrXVI,known_gene
912126,912435,309,1,0,chrXVI,novel_orf
912663,916962,4299,1,0,chrXVI,known_gene
919380,920487,1107,1,0,chrXVI,known_gene
939921,941136,1215,1,0,chrXVI,known_gene
943371,943896,525,1,0,chrXVI,known_gene
1411,1918,507,1,1,chrXVI,known_gene
2287,2623,336,1,1,chrXVI,novel_orf
13330,13651,321,1,1,chrXVI,novel_orf
17947,18385,438,1,1,chrXVI,novel_orf
30340,32803,2463,1,1,chrXVI,known_gene
47335,48802,1467,1,1,chrXVI,known_gene
69484,70951,1467,1,1,chrXVI,known_gene
73624,73927,303,1,1,chrXVI,known_gene
85585,86950,1365,1,1,chrXVI,known_gene
88516,90316,1800,1,1,chrXVI,known_gene
100495,101353,858,1,1,chrXVI,known_gene
103231,104647,1416,1,1,chrXVI,known_gene
106171,106822,651,1,1,chrXVI,known_gene
116176,116482,306,1,1,chrXVI,known_gene
118381,120031,1650,1,1,chrXVI,known_gene
120322,120733,411,1,1,chrXVI,novel_orf
133042,135424,2382,1,1,chrXVI,known_gene
147415,148423,1008,1,1,chrXVI,known_gene
150613,151330,717,1,1,chrXVI,known_gene
164275,165760,1485,1,1,chrXVI,known_gene
166255,167398,1143,1,1,chrXVI,known_gene
168466,168871,405,1,1,chrXVI,novel_orf
173533,173884,351,1,1,chrXVI,known_gene
175042,175864,822,1,1,chrXVI,known_gene
181402,182548,1146,1,1,chrXVI,known_gene
208156,209806,1650,1,1,chrXVI,known_gene
228313,228772,459,1,1,chrXVI,known_gene
237337,237979,642,1,1,chrXVI,known_gene
240826,241147,321,1,1,chrXVI,novel_orf
265027,266104,1077,1,1,chrXVI,known_gene
271309,272194,885,1,1,chrXVI,known_gene
313387,316486,3099,1,1,chrXVI,known_gene
329605,331699,2094,1,1,chrXVI,known_gene
335947,336367,420,1,1,chrXVI,known_gene
339943,340945,1002,1,1,chrXVI,known_gene
348445,348952,507,1,1,chrXVI,known_gene
353935,354331,396,1,1,chrXVI,novel_orf
355699,357676,1977,1,1,chrXVI,known_gene
360208,361579,1371,1,1,chrXVI,known_gene
364951,366430,1479,1,1,chrXVI,known_gene
373792,375169,1377,1,1,chrXVI,known_gene
381964,382993,1029,1,1,chrXVI,known_gene
407095,407539,444,1,1,chrXVI,known_gene
415762,418027,2265,1,1,chrXVI,known_gene
425461,425824,363,1,1,chrXVI,novel_orf
426232,427672,1440,1,1,chrXVI,known_gene
455758,456664,906,1,1,chrXVI,known_gene
462724,463060,336,1,1,chrXVI,novel_orf
465961,466261,300,1,1,chrXVI,known_gene
479224,480175,951,1,1,chrXVI,known_gene
482842,485686,2844,1,1,chrXVI,known_gene
495505,497719,2214,1,1,chrXVI,known_gene
521827,522190,363,1,1,chrXVI,known_gene
544630,548143,3513,1,1,chrXVI,known_gene
548485,550306,1821,1,1,chrXVI,known_gene
552019,553408,1389,1,1,chrXVI,known_gene
594475,596296,1821,1,1,chrXVI,known_gene
596749,599551,2802,1,1,chrXVI,known_gene
599869,600217,348,1,1,chrXVI,known_gene
610480,612724,2244,1,1,chrXVI,known_gene
647011,647347,336,1,1,chrXVI,known_gene
648703,649921,1218,1,1,chrXVI,known_gene
667675,670873,3198,1,1,chrXVI,known_gene
671125,672142,1017,1,1,chrXVI,known_gene
673750,674674,924,1,1,chrXVI,known_gene
677164,677641,477,1,1,chrXVI,known_gene
682219,682777,558,1,1,chrXVI,known_gene
685897,687598,1701,1,1,chrXVI,known_gene
688171,688807,636,1,1,chrXVI,known_gene
690106,691789,1683,1,1,chrXVI,known_gene
696475,696850,375,1,1,chrXVI,known_gene
711520,711877,357,1,1,chrXVI,known_gene
718378,718684,306,1,1,chrXVI,known_gene
723679,724003,324,1,1,chrXVI,novel_orf
729790,730213,423,1,1,chrXVI,known_gene
742453,743743,1290,1,1,chrXVI,known_gene
744688,745573,885,1,1,chrXVI,known_gene
754876,758128,3252,1,1,chrXVI,known_gene
758647,759481,834,1,1,chrXVI,known_gene
760024,767494,7470,1,1,chrXVI,known_gene
771652,773128,1476,1,1,chrXVI,known_gene
778582,780301,1719,1,1,chrXVI,known_gene
782044,785671,3627,1,1,chrXVI,known_gene
787960,789325,1365,1,1,chrXVI,known_gene
814390,815536,1146,1,1,chrXVI,known_gene
817072,817633,561,1,1,chrXVI,novel_orf
822619,824338,1719,1,1,chrXVI,known_gene
830998,831520,522,1,1,chrXVI,known_gene
844708,846031,1323,1,1,chrXVI,novel_orf
878623,880168,1545,1,1,chrXVI,known_gene
888964,891043,2079,1,1,chrXVI,known_gene
895960,897004,1044,1,1,chrXVI,known_gene
900754,901558,804,1,1,chrXVI,known_gene
921859,922777,918,1,1,chrXVI,known_gene
931375,932788,1413,1,1,chrXVI,known_gene
934033,935665,1632,1,1,chrXVI,known_gene
943879,944188,309,1,1,chrXVI,known_gene
944602,947701,3099,1,1,chrXVI,known_gene
18368,19079,711,1,2,chrXVI,novel_orf
22937,24701,1764,1,2,chrXVI,known_gene
38168,38798,630,1,2,chrXVI,known_gene
41042,42869,1827,1,2,chrXVI,known_gene
43958,44276,318,1,2,chrXVI,novel_orf
54614,54965,351,1,2,chrXVI,novel_orf
56747,58070,1323,1,2,chrXVI,novel_orf
63278,63860,582,1,2,chrXVI,known_gene
67724,68882,1158,1,2,chrXVI,known_gene
121766,125357,3591,1,2,chrXVI,known_gene
126005,126446,441,1,2,chrXVI,known_gene
138959,139409,450,1,2,chrXVI,known_gene
153494,154040,546,1,2,chrXVI,known_gene
157841,159593,1752,1,2,chrXVI,known_gene
159908,162341,2433,1,2,chrXVI,known_gene
176222,179021,2799,1,2,chrXVI,known_gene
179276,181115,1839,1,2,chrXVI,known_gene
187202,187655,453,1,2,chrXVI,novel_orf
191405,192650,1245,1,2,chrXVI,known_gene
203420,204941,1521,1,2,chrXVI,known_gene
205247,207647,2400,1,2,chrXVI,known_gene
218747,220088,1341,1,2,chrXVI,known_gene
223142,224036,894,1,2,chrXVI,known_gene
246989,250262,3273,1,2,chrXVI,known_gene
254813,255761,948,1,2,chrXVI,known_gene
257948,258305,357,1,2,chrXVI,novel_orf
268187,270893,2706,1,2,chrXVI,known_gene
273254,275867,2613,1,2,chrXVI,known_gene
295625,296249,624,1,2,chrXVI,novel_orf
296285,296654,369,1,2,chrXVI,known_gene
301715,302618,903,1,2,chrXVI,known_gene
316754,317516,762,1,2,chrXVI,known_gene
320087,320417,330,1,2,chrXVI,novel_orf
322070,323744,1674,1,2,chrXVI,known_gene
326627,327662,1035,1,2,chrXVI,known_gene
349118,349865,747,1,2,chrXVI,known_gene
361871,363362,1491,1,2,chrXVI,known_gene
366926,368018,1092,1,2,chrXVI,known_gene
394037,396572,2535,1,2,chrXVI,known_gene
396704,397064,360,1,2,chrXVI,novel_orf
403202,403625,423,1,2,chrXVI,novel_orf
418511,420011,1500,1,2,chrXVI,known_gene
420947,422786,1839,1,2,chrXVI,known_gene
429938,431369,1431,1,2,chrXVI,known_gene
431894,432299,405,1,2,chrXVI,known_gene
432587,434090,1503,1,2,chrXVI,known_gene
434522,435764,1242,1,2,chrXVI,known_gene
444578,445031,453,1,2,chrXVI,known_gene
459962,460559,597,1,2,chrXVI,known_gene
489764,490163,399,1,2,chrXVI,novel_orf
498095,499292,1197,1,2,chrXVI,known_gene
499664,500402,738,1,2,chrXVI,known_gene
503516,504242,726,1,2,chrXVI,known_gene
506696,509999,3303,1,2,chrXVI,known_gene
511100,511664,564,1,2,chrXVI,known_gene
515921,516323,402,1,2,chrXVI,novel_orf
527546,528692,1146,1,2,chrXVI,known_gene
536438,536852,414,1,2,chrXVI,novel_orf
539384,541970,2586,1,2,chrXVI,known_gene
556376,557837,1461,1,2,chrXVI,known_gene
573017,575102,2085,1,2,chrXVI,known_gene
576551,577358,807,1,2,chrXVI,known_gene
631514,633761,2247,1,2,chrXVI,known_gene
639524,640958,1434,1,2,chrXVI,known_gene
643835,645272,1437,1,2,chrXVI,known_gene
646835,647195,360,1,2,chrXVI,known_gene
656798,657344,546,1,2,chrXVI,known_gene
672470,673496,1026,1,2,chrXVI,known_gene
678950,679370,420,1,2,chrXVI,known_gene
681212,682112,900,1,2,chrXVI,known_gene
711353,711674,321,1,2,chrXVI,known_gene
724229,724571,342,1,2,chrXVI,novel_orf
725393,728615,3222,1,2,chrXVI,known_gene
740060,741392,1332,1,2,chrXVI,known_gene
747305,749000,1695,1,2,chrXVI,known_gene
790082,791120,1038,1,2,chrXVI,known_gene
792686,793736,1050,1,2,chrXVI,known_gene
798050,798857,807,1,2,chrXVI,known_gene
802358,804080,1722,1,2,chrXVI,known_gene
833810,834245,435,1,2,chrXVI,known_gene
841265,842669,1404,1,2,chrXVI,known_gene
846509,849980,3471,1,2,chrXVI,novel_orf
857582,859745,2163,1,2,chrXVI,known_gene
861305,864014,2709,1,2,chrXVI,known_gene
878075,878549,474,1,2,chrXVI,known_gene
889274,889577,303,1,2,chrXVI,known_gene
892331,893729,1398,1,2,chrXVI,known_gene
907217,909434,2217,1,2,chrXVI,known_gene
917573,917897,324,1,2,chrXVI,novel_orf
945932,946616,684,1,2,chrXVI,known_gene
945954,946569,615,-1,0,chrXVI,novel_orf
945249,945585,336,-1,0,chrXVI,novel_orf
933897,934461,564,-1,0,chrXVI,known_gene
924303,926937,2634,-1,0,chrXVI,known_gene
922908,923379,471,-1,0,chrXVI,known_gene
922125,922494,369,-1,0,chrXVI,novel_orf
917076,919041,1965,-1,0,chrXVI,known_gene
909732,911022,1290,-1,0,chrXVI,known_gene
908013,908340,327,-1,0,chrXVI,novel_orf
901095,901425,330,-1,0,chrXVI,novel_orf
897360,899667,2307,-1,0,chrXVI,known_gene
895896,896196,300,-1,0,chrXVI,novel_orf
893796,895764,1968,-1,0,chrXVI,known_gene
888042,888708,666,-1,0,chrXVI,known_gene
876846,877632,786,-1,0,chrXVI,known_gene
868644,869955,1311,-1,0,chrXVI,known_gene
854934,856257,1323,-1,0,chrXVI,novel_orf
831054,831675,621,-1,0,chrXVI,known_gene
815733,817923,2190,-1,0,chrXVI,known_gene
800490,800814,324,-1,0,chrXVI,novel_orf
791217,792204,987,-1,0,chrXVI,known_gene
789003,789312,309,-1,0,chrXVI,known_gene
784110,784479,369,-1,0,chrXVI,novel_orf
778890,779256,366,-1,0,chrXVI,novel_orf
773874,775182,1308,-1,0,chrXVI,known_gene
745827,746835,1008,-1,0,chrXVI,known_gene
736983,739569,2586,-1,0,chrXVI,known_gene
731223,731748,525,-1,0,chrXVI,known_gene
729756,730113,357,-1,0,chrXVI,known_gene
728946,729273,327,-1,0,chrXVI,known_gene
711402,713028,1626,-1,0,chrXVI,known_gene
700779,701757,978,-1,0,chrXVI,novel_orf
697146,698265,1119,-1,0,chrXVI,known_gene
695736,696819,1083,-1,0,chrXVI,known_gene
691932,692418,486,-1,0,chrXVI,known_gene
690792,691125,333,-1,0,chrXVI,novel_orf
684555,685437,882,-1,0,chrXVI,known_gene
677811,678120,309,-1,0,chrXVI,known_gene
674313,674700,387,-1,0,chrXVI,known_gene
665787,666243,456,-1,0,chrXVI,known_gene
649518,649869,351,-1,0,chrXVI,novel_orf
624468,626967,2499,-1,0,chrXVI,known_gene
620424,621258,834,-1,0,chrXVI,known_gene
600648,603357,2709,-1,0,chrXVI,known_gene
584631,585585,954,-1,0,chrXVI,known_gene
577584,581196,3612,-1,0,chrXVI,known_gene
564006,565041,1035,-1,0,chrXVI,known_gene
559332,559647,315,-1,0,chrXVI,novel_orf
553626,554328,702,-1,0,chrXVI,known_gene
546174,546480,306,-1,0,chrXVI,novel_orf
528984,529350,366,-1,0,chrXVI,known_gene
518733,520233,1500,-1,0,chrXVI,known_gene
488886,491364,2478,-1,0,chrXVI,known_gene
485154,485517,363,-1,0,chrXVI,novel_orf
475992,479001,3009,-1,0,chrXVI,known_gene
462480,463839,1359,-1,0,chrXVI,known_gene
453429,453735,306,-1,0,chrXVI,known_gene
451908,453057,1149,-1,0,chrXVI,known_gene
425250,425847,597,-1,0,chrXVI,known_gene
408009,408744,735,-1,0,chrXVI,known_gene
379119,381150,2031,-1,0,chrXVI,known_gene
368070,369441,1371,-1,0,chrXVI,known_gene
363519,364068,549,-1,0,chrXVI,known_gene
357999,359406,1407,-1,0,chrXVI,known_gene
350193,352275,2082,-1,0,chrXVI,known_gene
341067,344739,3672,-1,0,chrXVI,known_gene
340308,340695,387,-1,0,chrXVI,novel_orf
335952,337143,1191,-1,0,chrXVI,known_gene
320961,321630,669,-1,0,chrXVI,known_gene
317640,318945,1305,-1,0,chrXVI,known_gene
289668,291051,1383,-1,0,chrXVI,known_gene
278394,279699,1305,-1,0,chrXVI,known_gene
261726,264192,2466,-1,0,chrXVI,known_gene
259713,260931,1218,-1,0,chrXVI,known_gene
255912,256767,855,-1,0,chrXVI,known_gene
252033,254310,2277,-1,0,chrXVI,known_gene
241917,242700,783,-1,0,chrXVI,known_gene
239349,241497,2148,-1,0,chrXVI,known_gene
229038,230838,1800,-1,0,chrXVI,known_gene
224352,225741,1389,-1,0,chrXVI,known_gene
199494,202536,3042,-1,0,chrXVI,known_gene
197259,197580,321,-1,0,chrXVI,known_gene
194511,195426,915,-1,0,chrXVI,known_gene
185316,187725,2409,-1,0,chrXVI,known_gene
174342,174756,414,-1,0,chrXVI,known_gene
172032,172755,723,-1,0,chrXVI,known_gene
168087,169338,1251,-1,0,chrXVI,known_gene
156489,157593,1104,-1,0,chrXVI,known_gene
134946,135402,456,-1,0,chrXVI,novel_orf
130899,131259,360,-1,0,chrXVI,novel_orf
128631,129138,507,-1,0,chrXVI,known_gene
126633,128088,1455,-1,0,chrXVI,known_gene
120162,121167,1005,-1,0,chrXVI,known_gene
101607,102702,1095,-1,0,chrXVI,known_gene
100473,100863,390,-1,0,chrXVI,known_gene
96495,98625,2130,-1,0,chrXVI,known_gene
90621,95109,4488,-1,0,chrXVI,known_gene
79710,82356,2646,-1,0,chrXVI,known_gene
76668,79353,2685,-1,0,chrXVI,known_gene
73362,73881,519,-1,0,chrXVI,known_gene
51243,52671,1428,-1,0,chrXVI,known_gene
44550,46506,1956,-1,0,chrXVI,known_gene
30783,31104,321,-1,0,chrXVI,novel_orf
30348,30729,381,-1,0,chrXVI,novel_orf
26610,28164,1554,-1,0,chrXVI,known_gene
13227,14355,1128,-1,0,chrXVI,known_gene
7932,8427,495,-1,0,chrXVI,known_gene
279,5667,5388,-1,0,chrXVI,known_gene
939278,939671,393,-1,1,chrXVI,known_gene
938147,939032,885,-1,1,chrXVI,known_gene
911987,912479,492,-1,1,chrXVI,known_gene
903503,903872,369,-1,1,chrXVI,novel_orf
888284,888635,351,-1,1,chrXVI,known_gene
886523,887837,1314,-1,1,chrXVI,known_gene
876281,876629,348,-1,1,chrXVI,known_gene
868859,869441,582,-1,1,chrXVI,known_gene
866714,868304,1590,-1,1,chrXVI,known_gene
850988,854456,3468,-1,1,chrXVI,novel_orf
837908,839777,1869,-1,1,chrXVI,known_gene
835562,837413,1851,-1,1,chrXVI,known_gene
826832,828140,1308,-1,1,chrXVI,known_gene
825644,826559,915,-1,1,chrXVI,known_gene
819764,821423,1659,-1,1,chrXVI,known_gene
818129,818693,564,-1,1,chrXVI,known_gene
813155,814058,903,-1,1,chrXVI,known_gene
810983,812453,1470,-1,1,chrXVI,known_gene
808946,810269,1323,-1,1,chrXVI,novel_orf
795977,797210,1233,-1,1,chrXVI,known_gene
793910,794666,756,-1,1,chrXVI,known_gene
793373,793781,408,-1,1,chrXVI,known_gene
786140,786575,435,-1,1,chrXVI,known_gene
768491,768893,402,-1,1,chrXVI,novel_orf
749255,751919,2664,-1,1,chrXVI,known_gene
741437,742064,627,-1,1,chrXVI,known_gene
733622,736433,2811,-1,1,chrXVI,known_gene
724841,725144,303,-1,1,chrXVI,known_gene
710309,710738,429,-1,1,chrXVI,novel_orf
705881,706493,612,-1,1,chrXVI,novel_orf
702113,703970,1857,-1,1,chrXVI,known_gene
697130,697502,372,-1,1,chrXVI,known_gene
692795,694838,2043,-1,1,chrXVI,known_gene
682940,684353,1413,-1,1,chrXVI,known_gene
681329,681749,420,-1,1,chrXVI,novel_orf
664952,665366,414,-1,1,chrXVI,known_gene
661136,664673,3537,-1,1,chrXVI,known_gene
655139,656552,1413,-1,1,chrXVI,known_gene
613376,614558,1182,-1,1,chrXVI,known_gene
608825,610031,1206,-1,1,chrXVI,known_gene
592331,593069,738,-1,1,chrXVI,known_gene
590282,591026,744,-1,1,chrXVI,known_gene
583061,584042,981,-1,1,chrXVI,known_gene
561503,563768,2265,-1,1,chrXVI,known_gene
550631,551657,1026,-1,1,chrXVI,known_gene
542081,543848,1767,-1,1,chrXVI,known_gene
530270,530729,459,-1,1,chrXVI,novel_orf
525809,526883,1074,-1,1,chrXVI,known_gene
512312,514178,1866,-1,1,chrXVI,known_gene
504338,506312,1974,-1,1,chrXVI,known_gene
502472,503030,558,-1,1,chrXVI,known_gene
492017,492926,909,-1,1,chrXVI,known_gene
487361,488207,846,-1,1,chrXVI,known_gene
486563,486911,348,-1,1,chrXVI,known_gene
481427,481901,474,-1,1,chrXVI,known_gene
473039,474707,1668,-1,1,chrXVI,known_gene
470831,471248,417,-1,1,chrXVI,novel_orf
469925,470474,549,-1,1,chrXVI,known_gene
466643,466943,300,-1,1,chrXVI,known_gene
460778,461966,1188,-1,1,chrXVI,known_gene
445841,450377,4536,-1,1,chrXVI,known_gene
439427,442742,3315,-1,1,chrXVI,novel_orf
424214,425096,882,-1,1,chrXVI,known_gene
420047,420518,471,-1,1,chrXVI,known_gene
419549,419852,303,-1,1,chrXVI,novel_orf
409367,410090,723,-1,1,chrXVI,known_gene
396701,398105,1404,-1,1,chrXVI,known_gene
364385,364727,342,-1,1,chrXVI,known_gene
360002,360305,303,-1,1,chrXVI,known_gene
352862,355412,2550,-1,1,chrXVI,known_gene
332099,335486,3387,-1,1,chrXVI,known_gene
327863,328730,867,-1,1,chrXVI,known_gene
324410,326264,1854,-1,1,chrXVI,known_gene
291365,292427,1062,-1,1,chrXVI,known_gene
287513,289034,1521,-1,1,chrXVI,known_gene
283463,286061,2598,-1,1,chrXVI,known_gene
276161,277529,1368,-1,1,chrXVI,known_gene
232592,237107,4515,-1,1,chrXVI,known_gene
231302,231644,342,-1,1,chrXVI,novel_orf
220166,222773,2607,-1,1,chrXVI,known_gene
216011,218363,2352,-1,1,chrXVI,known_gene
213041,213962,921,-1,1,chrXVI,known_gene
183596,184679,1083,-1,1,chrXVI,known_gene
182654,183056,402,-1,1,chrXVI,known_gene
169769,171155,1386,-1,1,chrXVI,known_gene
154289,156230,1941,-1,1,chrXVI,known_gene
151514,153149,1635,-1,1,chrXVI,known_gene
148568,150191,1623,-1,1,chrXVI,known_gene
147515,147821,306,-1,1,chrXVI,novel_orf
139619,143171,3552,-1,1,chrXVI,known_gene
112268,112607,339,-1,1,chrXVI,novel_orf
109118,109520,402,-1,1,chrXVI,novel_orf
104945,105440,495,-1,1,chrXVI,known_gene
89573,89921,348,-1,1,chrXVI,novel_orf
64976,66614,1638,-1,1,chrXVI,known_gene
48995,49304,309,-1,1,chrXVI,known_gene
15404,16868,1464,-1,1,chrXVI,known_gene
1364,1940,576,-1,1,chrXVI,known_gene
946855,947338,483,-1,2,chrXVI,known_gene
945871,946555,684,-1,2,chrXVI,novel_orf
927964,928294,330,-1,2,chrXVI,known_gene
892312,892684,372,-1,2,chrXVI,known_gene
891100,892078,978,-1,2,chrXVI,known_gene
887143,887452,309,-1,2,chrXVI,known_gene
882982,883318,336,-1,2,chrXVI,known_gene
864448,866422,1974,-1,2,chrXVI,known_gene
832060,833458,1398,-1,2,chrXVI,known_gene
825346,825676,330,-1,2,chrXVI,known_gene
805000,808468,3468,-1,2,chrXVI,novel_orf
802324,802837,513,-1,2,chrXVI,known_gene
789076,789385,309,-1,2,chrXVI,known_gene
725869,726181,312,-1,2,chrXVI,novel_orf
721036,724717,3681,-1,2,chrXVI,known_gene
719557,720490,933,-1,2,chrXVI,known_gene
716155,718468,2313,-1,2,chrXVI,known_gene
708496,709843,1347,-1,2,chrXVI,known_gene
704224,704656,432,-1,2,chrXVI,known_gene
681574,681913,339,-1,2,chrXVI,novel_orf
675976,676882,906,-1,2,chrXVI,known_gene
674860,675631,771,-1,2,chrXVI,known_gene
654523,654877,354,-1,2,chrXVI,known_gene
650434,653662,3228,-1,2,chrXVI,known_gene
646447,647038,591,-1,2,chrXVI,known_gene
640471,640810,339,-1,2,chrXVI,novel_orf
637378,639019,1641,-1,2,chrXVI,known_gene
633205,633586,381,-1,2,chrXVI,novel_orf
603910,607312,3402,-1,2,chrXVI,known_gene
593485,593917,432,-1,2,chrXVI,known_gene
587188,587518,330,-1,2,chrXVI,known_gene
569335,571378,2043,-1,2,chrXVI,known_gene
567268,568996,1728,-1,2,chrXVI,known_gene
565786,566671,885,-1,2,chrXVI,known_gene
535819,538936,3117,-1,2,chrXVI,known_gene
533641,534703,1062,-1,2,chrXVI,known_gene
528175,528574,399,-1,2,chrXVI,novel_orf
514510,517018,2508,-1,2,chrXVI,known_gene
506977,507379,402,-1,2,chrXVI,novel_orf
500674,502183,1509,-1,2,chrXVI,known_gene
475117,475741,624,-1,2,chrXVI,known_gene
457117,458458,1341,-1,2,chrXVI,known_gene
453991,454990,999,-1,2,chrXVI,known_gene
437332,439495,2163,-1,2,chrXVI,novel_orf
433087,433447,360,-1,2,chrXVI,novel_orf
428710,429616,906,-1,2,chrXVI,known_gene
422884,423892,1008,-1,2,chrXVI,known_gene
422029,422419,390,-1,2,chrXVI,novel_orf
421369,421867,498,-1,2,chrXVI,novel_orf
418498,418984,486,-1,2,chrXVI,known_gene
406171,406498,327,-1,2,chrXVI,known_gene
398479,404083,5604,-1,2,chrXVI,known_gene
384772,386446,1674,-1,2,chrXVI,known_gene
377290,377815,525,-1,2,chrXVI,known_gene
369838,370690,852,-1,2,chrXVI,known_gene
361930,362365,435,-1,2,chrXVI,novel_orf
345556,347389,1833,-1,2,chrXVI,known_gene
337435,338620,1185,-1,2,chrXVI,known_gene
319225,320767,1542,-1,2,chrXVI,known_gene
308827,309604,777,-1,2,chrXVI,known_gene
306532,308221,1689,-1,2,chrXVI,known_gene
299887,301228,1341,-1,2,chrXVI,known_gene
298570,299503,933,-1,2,chrXVI,known_gene
292816,296647,3831,-1,2,chrXVI,known_gene
282685,283003,318,-1,2,chrXVI,known_gene
272293,272827,534,-1,2,chrXVI,known_gene
266179,267535,1356,-1,2,chrXVI,known_gene
257215,259336,2121,-1,2,chrXVI,known_gene
255235,255586,351,-1,2,chrXVI,novel_orf
250906,251668,762,-1,2,chrXVI,known_gene
244318,246220,1902,-1,2,chrXVI,known_gene
243205,244027,822,-1,2,chrXVI,known_gene
237955,239077,1122,-1,2,chrXVI,known_gene
226168,227371,1203,-1,2,chrXVI,known_gene
219106,219466,360,-1,2,chrXVI,novel_orf
203305,203689,384,-1,2,chrXVI,known_gene
195949,197788,1839,-1,2,chrXVI,known_gene
179539,179920,381,-1,2,chrXVI,novel_orf
176563,176983,420,-1,2,chrXVI,novel_orf
163921,164266,345,-1,2,chrXVI,known_gene
162631,163597,966,-1,2,chrXVI,known_gene
87013,88033,1020,-1,2,chrXVI,known_gene
84508,85297,789,-1,2,chrXVI,known_gene
82624,84196,1572,-1,2,chrXVI,known_gene
74308,74719,411,-1,2,chrXVI,known_gene
71062,73006,1944,-1,2,chrXVI,known_gene
53497,55153,1656,-1,2,chrXVI,known_gene
43282,44344,1062,-1,2,chrXVI,known_gene
15052,15355,303,-1,2,chrXVI,known_gene
9556,10870,1314,-1,2,chrXVI,known_gene
18919,19273,354,1,1,chrM,novel_orf
19489,19843,354,1,1,chrM,novel_orf
14300,14924,624,1,2,chrM,novel_orf
17129,17504,375,1,2,chrM,novel_orf
17552,18119,567,1,2,chrM,novel_orf
18137,18830,693,1,2,chrM,novel_orf
37790,38201,411,1,2,chrM,novel_orf
14434,14746,312,-1,2,chrM,novel_orf
